,Player,MP,FG,FGA,FG%,2P,2PA,2P%,3P,3PA,3P%,FT,FTA,FT%,ORB,DRB,TRB,AST,STL,BLK,TOV,PF,PTS,Starter,game_id,TEAM
17,School Totals,200,34,61,.557,27,47,.574,7,14,.500,8,13,.615,9,25,34,20,7,6,16,22,83,False,0,Indiana
14,School Totals,200,24,54,.444,19,43,.442,5,11,.455,16,30,.533,14,24,38,11,11,1,17,19,69,False,1,Indiana
12,School Totals,200,28,69,.406,25,54,.463,3,15,.200,12,27,.444,18,19,37,13,10,2,20,20,71,False,2,Indiana
11,School Totals,200,24,57,.421,19,44,.432,5,13,.385,14,22,.636,5,26,31,14,8,6,12,27,67,False,3,Indiana
13,School Totals,200,20,57,.351,15,49,.306,5,8,.625,21,28,.750,15,25,40,11,9,1,15,23,66,False,4,Indiana
16,School Totals,200,25,52,.481,19,36,.528,6,16,.375,34,44,.773,7,26,33,19,13,5,18,23,90,False,5,Indiana
12,School Totals,200,23,70,.329,16,44,.364,7,26,.269,15,22,.682,19,20,39,13,5,3,16,22,68,False,6,Indiana
11,School Totals,200,24,54,.444,23,47,.489,1,7,.143,25,34,.735,7,27,34,14,7,10,12,19,74,False,7,Indiana
16,School Totals,200,28,60,.467,19,41,.463,9,19,.474,8,14,.571,7,15,22,17,6,3,9,16,73,False,8,Indiana
16,School Totals,200,30,59,.508,23,36,.639,7,23,.304,14,21,.667,15,29,44,22,4,6,16,16,81,False,9,Indiana
12,School Totals,200,20,48,.417,15,37,.405,5,11,.455,22,32,.688,11,18,29,9,10,5,23,20,67,False,10,Indiana
16,School Totals,200,32,58,.552,23,36,.639,9,22,.409,17,26,.654,15,33,48,20,11,7,18,17,90,False,11,Indiana
10,School Totals,200,23,49,.469,18,36,.500,5,13,.385,20,29,.690,6,25,31,13,10,2,9,17,71,False,12,Indiana
15,School Totals,200,18,53,.340,14,35,.400,4,18,.222,14,17,.824,10,22,32,9,4,1,23,22,54,False,13,Indiana
10,School Totals,200,22,53,.415,16,36,.444,6,17,.353,10,18,.556,8,21,29,10,8,3,15,28,60,False,14,Indiana
11,School Totals,200,19,52,.365,18,37,.486,1,15,.067,6,12,.500,11,17,28,9,5,2,18,22,45,False,15,Indiana
10,School Totals,225,24,57,.421,16,40,.400,8,17,.471,25,40,.625,17,23,40,16,6,3,13,22,81,False,16,Indiana
11,School Totals,200,24,54,.444,15,34,.441,9,20,.450,10,14,.714,9,22,31,15,9,8,12,21,67,False,17,Indiana
12,School Totals,200,16,45,.356,16,36,.444,0,9,.000,11,15,.733,9,12,21,3,9,5,16,17,43,False,18,Indiana
11,School Totals,200,21,60,.350,12,37,.324,9,23,.391,19,23,.826,12,17,29,11,5,1,13,21,70,False,19,Indiana
11,School Totals,200,27,60,.450,19,44,.432,8,16,.500,13,18,.722,10,20,30,15,7,3,10,20,75,False,20,Indiana
14,School Totals,200,18,51,.353,16,34,.471,2,17,.118,23,27,.852,7,21,28,10,7,2,6,23,61,False,21,Indiana
14,School Totals,200,20,54,.370,15,43,.349,5,11,.455,7,14,.500,9,25,34,11,2,4,13,18,52,False,22,Indiana
13,School Totals,200,20,43,.465,16,36,.444,4,7,.571,11,16,.688,6,17,23,10,4,0,21,18,55,False,23,Indiana
11,School Totals,200,15,43,.349,12,30,.400,3,13,.231,25,28,.893,12,12,24,5,2,2,15,17,58,False,24,Indiana
14,School Totals,200,19,59,.322,13,38,.342,6,21,.286,14,22,.636,13,15,28,11,5,1,9,17,58,False,25,Indiana
10,School Totals,200,18,51,.353,18,46,.391,0,5,.000,10,20,.500,12,17,29,8,7,5,18,17,46,False,26,Indiana
10,School Totals,200,18,40,.450,17,32,.531,1,8,.125,20,25,.800,5,18,23,4,4,2,20,31,57,False,27,Indiana
14,School Totals,200,23,59,.390,18,43,.419,5,16,.313,4,5,.800,10,23,33,7,3,1,17,25,55,False,28,Indiana
13,School Totals,225,26,60,.433,16,37,.432,10,23,.435,26,32,.813,17,24,41,15,11,6,15,15,88,False,29,Indiana
14,School Totals,200,20,46,.435,15,31,.484,5,15,.333,13,17,.765,10,16,26,10,2,2,18,21,58,False,30,Indiana
15,School Totals,200,30,57,.526,16,29,.552,14,28,.500,14,20,.700,15,21,36,22,9,5,23,27,88,False,31,Indiana
13,School Totals,200,24,40,.600,20,31,.645,4,9,.444,15,21,.714,4,34,38,14,6,5,20,24,67,False,32,Indiana
15,School Totals,200,23,60,.383,18,43,.419,5,17,.294,20,29,.690,15,24,39,16,10,1,15,19,71,False,33,Indiana
13,School Totals,200,24,45,.533,20,35,.571,4,10,.400,15,28,.536,9,19,28,10,10,7,15,20,67,False,34,Indiana
16,School Totals,200,24,58,.414,19,40,.475,5,18,.278,19,25,.760,12,21,33,13,8,6,13,14,72,False,35,Indiana
16,School Totals,200,36,64,.563,28,45,.622,8,19,.421,20,28,.714,14,30,44,23,11,4,15,25,100,False,36,Indiana
12,School Totals,200,28,55,.509,21,33,.636,7,22,.318,13,20,.650,11,13,24,15,4,2,10,20,76,False,37,Indiana
15,School Totals,200,26,47,.553,20,33,.606,6,14,.429,21,30,.700,8,27,35,13,7,5,19,16,79,False,38,Indiana
12,School Totals,200,23,54,.426,19,38,.500,4,16,.250,12,16,.750,5,27,32,12,3,5,14,31,62,False,39,Indiana
14,School Totals,200,32,52,.615,23,36,.639,9,16,.563,15,20,.750,4,30,34,18,10,2,17,18,88,False,40,Indiana
15,School Totals,200,35,63,.556,25,41,.610,10,22,.455,22,30,.733,12,23,35,24,10,2,8,13,102,False,41,Indiana
13,School Totals,200,20,47,.426,18,34,.529,2,13,.154,19,29,.655,7,21,28,9,7,2,14,20,61,False,42,Indiana
13,School Totals,200,24,59,.407,19,45,.422,5,14,.357,16,25,.640,16,14,30,9,8,2,12,22,69,False,43,Indiana
13,School Totals,200,23,54,.426,14,34,.412,9,20,.450,5,8,.625,9,16,25,13,5,1,9,21,60,False,44,Indiana
12,School Totals,200,25,50,.500,16,26,.615,9,24,.375,8,14,.571,4,16,20,13,4,1,14,30,67,False,45,Indiana
12,School Totals,200,23,61,.377,16,41,.390,7,20,.350,10,12,.833,10,16,26,12,9,5,6,20,63,False,46,Indiana
13,School Totals,200,27,58,.466,21,44,.477,6,14,.429,21,25,.840,11,19,30,18,2,7,13,29,81,False,47,Indiana
11,School Totals,200,29,43,.674,23,29,.793,6,14,.429,16,20,.800,5,28,33,11,2,2,16,21,80,False,48,Indiana
11,School Totals,200,25,49,.510,23,42,.548,2,7,.286,8,11,.727,5,19,24,4,2,1,7,17,60,False,49,Indiana
11,School Totals,200,26,70,.371,18,43,.419,8,27,.296,17,20,.850,15,19,34,16,9,1,14,29,77,False,50,Indiana
11,School Totals,200,18,48,.375,13,33,.394,5,15,.333,11,11,1.000,8,20,28,6,5,4,13,13,52,False,51,Indiana
11,School Totals,225,29,59,.492,18,38,.474,11,21,.524,14,22,.636,7,23,30,14,4,2,13,22,83,False,52,Indiana
11,School Totals,200,21,53,.396,16,29,.552,5,24,.208,13,15,.867,11,22,33,9,7,0,9,20,60,False,53,Indiana
12,School Totals,200,22,53,.415,17,39,.436,5,14,.357,14,17,.824,6,16,22,6,7,0,11,21,63,False,54,Indiana
11,School Totals,200,22,62,.355,20,49,.408,2,13,.154,7,7,1.000,8,20,28,9,9,2,13,22,53,False,55,Indiana
14,School Totals,200,26,55,.473,22,39,.564,4,16,.250,13,22,.591,8,24,32,12,5,3,13,30,69,False,56,Indiana
12,School Totals,200,23,46,.500,19,33,.576,4,13,.308,14,19,.737,8,17,25,10,6,1,12,22,64,False,57,Indiana
12,School Totals,200,19,50,.380,11,31,.355,8,19,.421,15,20,.750,11,20,31,7,7,0,11,22,61,False,58,Indiana
15,School Totals,200,20,52,.385,14,31,.452,6,21,.286,15,20,.750,7,21,28,11,2,0,13,25,61,False,59,Indiana
12,School Totals,200,22,47,.468,20,36,.556,2,11,.182,21,26,.808,7,16,23,5,0,0,5,19,67,False,60,Indiana
15,School Totals,200,18,57,.316,15,40,.375,3,17,.176,9,11,.818,7,18,25,6,3,2,10,13,48,False,61,Indiana
11,School Totals,200,22,45,.489,18,27,.667,4,18,.222,7,11,.636,4,15,19,13,10,4,9,19,55,False,62,Indiana
17,School Totals,200,34,52,.654,27,38,.711,7,14,.500,21,24,.875,8,23,31,21,9,2,14,14,96,False,63,Indiana
17,School Totals,200,25,50,.500,18,32,.563,7,18,.389,21,31,.677,6,28,34,12,15,7,18,19,78,False,64,Indiana
16,School Totals,200,33,59,.559,22,38,.579,11,21,.524,17,25,.680,7,28,35,24,7,5,12,22,94,False,65,Indiana
14,School Totals,200,28,49,.571,25,43,.581,3,6,.500,35,47,.745,9,18,27,16,8,1,9,25,94,False,66,Indiana
17,School Totals,200,29,59,.492,26,41,.634,3,18,.167,12,23,.522,14,27,41,19,5,1,13,19,73,False,67,Indiana
12,School Totals,200,19,47,.404,11,34,.324,8,13,.615,29,36,.806,11,18,29,9,14,6,16,18,75,False,68,Indiana
11,School Totals,200,30,62,.484,23,49,.469,7,13,.538,19,23,.826,12,22,34,8,10,4,13,20,86,False,69,Indiana
17,School Totals,200,34,66,.515,29,53,.547,5,13,.385,11,14,.786,8,25,33,20,13,7,9,10,84,False,70,Indiana
9,School Totals,200,25,58,.431,16,43,.372,9,15,.600,14,17,.824,12,16,28,12,7,2,18,16,73,False,71,Indiana
11,School Totals,200,24,57,.421,21,50,.420,3,7,.429,18,22,.818,12,21,33,9,4,2,11,25,69,False,72,Indiana
17,School Totals,200,35,52,.673,24,32,.750,11,20,.550,26,37,.703,5,29,34,27,9,2,8,12,107,False,73,Indiana
15,School Totals,200,26,55,.473,15,28,.536,11,27,.407,26,37,.703,12,27,39,19,12,3,15,15,89,False,74,Indiana
11,School Totals,200,27,64,.422,21,47,.447,6,17,.353,5,9,.556,12,18,30,10,4,3,13,18,65,False,75,Indiana
11,School Totals,200,27,59,.458,22,46,.478,5,13,.385,15,22,.682,8,18,26,6,7,4,11,20,74,False,76,Indiana
11,School Totals,200,27,49,.551,20,38,.526,7,11,.636,12,19,.632,5,23,28,15,5,6,15,15,73,False,77,Indiana
11,School Totals,200,24,47,.511,8,23,.348,16,24,.667,24,32,.750,4,23,27,17,5,3,16,23,88,False,78,Indiana
11,School Totals,200,24,55,.436,20,37,.541,4,18,.222,22,25,.880,12,20,32,6,6,5,15,19,74,False,79,Indiana
11,School Totals,200,24,55,.436,17,34,.500,7,21,.333,8,11,.727,8,18,26,12,4,2,16,19,63,False,80,Indiana
11,School Totals,200,26,51,.510,18,33,.545,8,18,.444,9,13,.692,5,28,33,17,3,2,14,12,69,False,81,Indiana
10,School Totals,200,24,45,.533,17,29,.586,7,16,.438,18,23,.783,7,23,30,10,5,6,9,25,73,False,82,Indiana
11,School Totals,200,21,46,.457,18,38,.474,3,8,.375,5,10,.500,6,18,24,4,3,1,10,18,50,False,83,Indiana
16,School Totals,200,37,67,.552,33,51,.647,4,16,.250,25,31,.806,18,17,35,20,7,5,13,17,103,False,84,Indiana
11,School Totals,200,21,47,.447,16,33,.485,5,14,.357,9,13,.692,7,22,29,9,1,0,14,17,56,False,85,Indiana
12,School Totals,200,23,55,.418,20,45,.444,3,10,.300,29,35,.829,12,32,44,10,1,7,11,17,78,False,86,Indiana
11,School Totals,200,21,42,.500,14,30,.467,7,12,.583,35,42,.833,5,20,25,15,6,3,10,16,84,False,87,Indiana
10,School Totals,200,27,55,.491,25,42,.595,2,13,.154,15,18,.833,10,19,29,16,7,2,8,15,71,False,88,Indiana
14,School Totals,200,20,53,.377,14,37,.378,6,16,.375,20,26,.769,11,22,33,13,2,4,14,19,66,False,89,Indiana
17,School Totals,200,26,51,.510,22,41,.537,4,10,.400,19,25,.760,15,19,34,13,7,2,16,15,75,False,90,Indiana
15,School Totals,200,21,48,.438,15,36,.417,6,12,.500,21,25,.840,8,29,37,11,5,5,13,18,69,False,91,Indiana
11,School Totals,200,23,48,.479,18,37,.486,5,11,.455,19,22,.864,9,21,30,8,10,2,9,16,70,False,92,Indiana
13,School Totals,200,28,53,.528,18,35,.514,10,18,.556,19,25,.760,6,28,34,16,6,5,11,14,85,False,93,Indiana
14,School Totals,200,19,52,.365,11,34,.324,8,18,.444,29,36,.806,11,27,38,11,4,2,10,16,75,False,94,Indiana
11,School Totals,200,25,51,.490,22,45,.489,3,6,.500,18,22,.818,7,19,26,8,1,0,10,16,71,False,95,Indiana
10,School Totals,200,32,54,.593,25,41,.610,7,13,.538,8,10,.800,7,14,21,15,12,0,12,12,79,False,96,Indiana
10,School Totals,200,24,46,.522,18,33,.545,6,13,.462,9,11,.818,7,26,33,13,6,2,22,13,63,False,97,Indiana
11,School Totals,200,36,69,.522,31,51,.608,5,18,.278,13,17,.765,9,19,28,16,3,2,8,27,90,False,98,Indiana
14,School Totals,200,30,54,.556,22,33,.667,8,21,.381,29,34,.853,11,35,46,16,12,6,17,16,97,False,99,Indiana
13,School Totals,200,28,58,.483,19,34,.559,9,24,.375,22,30,.733,12,27,39,16,8,4,10,15,87,False,100,Indiana
14,School Totals,200,30,53,.566,21,32,.656,9,21,.429,30,44,.682,16,25,41,24,11,3,9,12,99,False,101,Indiana
10,School Totals,200,22,49,.449,17,33,.515,5,16,.313,17,24,.708,8,27,35,11,4,0,12,17,66,False,102,Indiana
10,School Totals,225,23,49,.469,13,32,.406,10,17,.588,26,36,.722,8,22,30,12,8,2,13,17,82,False,103,Indiana
14,School Totals,200,38,63,.603,31,46,.674,7,17,.412,18,24,.750,9,32,41,15,9,4,11,20,101,False,104,Indiana
14,School Totals,200,33,74,.446,25,54,.463,8,20,.400,9,12,.750,13,31,44,21,6,6,10,16,83,False,105,Indiana
14,School Totals,200,31,60,.517,23,36,.639,8,24,.333,17,20,.850,12,25,37,21,11,1,14,15,87,False,106,Indiana
14,School Totals,200,39,72,.542,32,51,.627,7,21,.333,15,20,.750,19,33,52,20,9,5,14,16,100,False,107,Indiana
11,School Totals,225,27,63,.429,22,51,.431,5,12,.417,27,38,.711,12,19,31,14,13,4,13,18,86,False,108,Indiana
13,School Totals,200,36,51,.706,27,39,.692,9,12,.750,12,19,.632,9,31,40,27,8,3,19,16,93,False,109,Indiana
14,School Totals,200,28,55,.509,22,43,.512,6,12,.500,26,27,.963,11,28,39,11,6,5,15,16,88,False,110,Indiana
14,School Totals,200,29,57,.509,18,32,.563,11,25,.440,24,31,.774,8,29,37,21,5,7,15,20,93,False,111,Indiana
11,School Totals,200,26,65,.400,22,51,.431,4,14,.286,13,18,.722,13,32,45,16,5,3,15,18,69,False,112,Indiana
11,School Totals,200,22,42,.524,14,26,.538,8,16,.500,22,34,.647,6,25,31,14,10,2,17,18,74,False,113,Indiana
10,School Totals,200,27,53,.509,19,34,.559,8,19,.421,26,40,.650,13,17,30,14,9,3,15,15,88,False,114,Indiana
10,School Totals,200,20,54,.370,17,42,.405,3,12,.250,16,19,.842,13,22,35,7,4,0,11,16,59,False,115,Indiana
11,School Totals,200,20,42,.476,16,33,.485,4,9,.444,23,31,.742,10,23,33,10,4,2,6,20,67,False,116,Indiana
11,School Totals,200,20,44,.455,9,24,.375,11,20,.550,21,37,.568,13,24,37,14,8,4,18,19,72,False,117,Indiana
11,School Totals,200,27,53,.509,19,32,.594,8,21,.381,13,20,.650,8,19,27,10,9,4,16,13,75,False,118,Indiana
14,School Totals,200,33,67,.493,21,42,.500,12,25,.480,19,20,.950,15,19,34,21,10,5,8,19,97,False,119,Indiana
11,School Totals,200,26,50,.520,19,32,.594,7,18,.389,22,25,.880,8,28,36,13,6,5,16,14,81,False,120,Indiana
12,School Totals,200,25,50,.500,16,33,.485,9,17,.529,13,14,.929,8,20,28,16,5,4,14,15,72,False,121,Indiana
10,School Totals,200,26,49,.531,19,31,.613,7,18,.389,22,28,.786,7,23,30,11,3,1,8,15,81,False,122,Indiana
12,School Totals,200,22,48,.458,14,32,.438,8,16,.500,24,29,.828,13,23,36,8,8,5,9,12,76,False,123,Indiana
15,School Totals,200,30,54,.556,22,35,.629,8,19,.421,15,24,.625,11,26,37,16,10,7,14,18,83,False,124,Indiana
12,School Totals,200,27,61,.443,19,43,.442,8,18,.444,10,15,.667,8,20,28,12,7,4,10,19,72,False,125,Indiana
11,School Totals,200,22,52,.423,13,29,.448,9,23,.391,20,24,.833,8,17,25,12,6,4,10,22,73,False,126,Indiana
11,School Totals,200,21,54,.389,19,40,.475,2,14,.143,29,42,.690,13,20,33,10,11,6,12,25,73,False,127,Indiana
11,School Totals,200,21,53,.396,15,38,.395,6,15,.400,10,13,.769,7,21,28,9,2,4,12,14,58,False,128,Indiana
11,School Totals,200,30,70,.429,23,54,.426,7,16,.438,5,9,.556,19,28,47,12,2,2,14,18,72,False,129,Indiana
11,School Totals,200,27,50,.540,22,33,.667,5,17,.294,21,24,.875,9,24,33,16,9,6,13,19,80,False,130,Indiana
10,School Totals,200,21,55,.382,16,38,.421,5,17,.294,9,14,.643,10,17,27,10,9,2,13,21,56,False,131,Indiana
13,School Totals,200,29,55,.527,20,32,.625,9,23,.391,16,21,.762,12,25,37,17,3,3,9,8,83,False,132,Indiana
10,School Totals,200,19,45,.422,15,32,.469,4,13,.308,16,20,.800,4,27,31,9,0,2,12,8,58,False,133,Indiana
12,School Totals,203,16,47,.340,13,32,.406,3,15,.200,15,24,.625,10,20,30,8,6,2,17,18,50,False,134,Indiana
18,School Totals,200,27,59,.458,26,51,.510,1,8,.125,45,55,.818,15,41,56,8,3,13,19,20,100,False,135,Indiana
12,School Totals,200,27,71,.380,20,45,.444,7,26,.269,12,17,.706,20,24,44,13,7,2,13,22,73,False,136,Indiana
19,School Totals,200,36,63,.571,30,48,.625,6,15,.400,27,41,.659,16,36,52,9,10,10,13,17,105,False,137,Indiana
12,School Totals,200,27,54,.500,21,37,.568,6,17,.353,30,49,.612,13,29,42,9,7,9,17,23,90,False,138,Indiana
15,School Totals,200,34,66,.515,31,53,.585,3,13,.231,31,36,.861,14,24,38,16,4,4,12,23,102,False,139,Indiana
12,School Totals,200,20,49,.408,17,37,.459,3,12,.250,15,22,.682,11,21,32,10,4,1,19,17,58,False,140,Indiana
19,School Totals,200,24,59,.407,20,43,.465,4,16,.250,25,35,.714,17,39,56,12,8,7,16,22,77,False,141,Indiana
16,School Totals,200,15,41,.366,11,27,.407,4,14,.286,18,24,.750,9,17,26,6,4,4,14,19,52,False,142,Indiana
17,School Totals,200,32,69,.464,26,51,.510,6,18,.333,19,28,.679,15,33,48,17,9,4,11,17,89,False,143,Indiana
14,School Totals,200,30,60,.500,21,39,.538,9,21,.429,12,17,.706,12,39,51,14,6,3,16,15,81,False,144,Indiana
12,School Totals,200,26,63,.413,19,43,.442,7,20,.350,13,16,.813,11,20,31,15,8,4,13,22,72,False,145,Indiana
19,School Totals,200,24,44,.545,19,32,.594,5,12,.417,26,35,.743,7,23,30,13,8,5,20,13,79,False,146,Indiana
16,School Totals,200,32,51,.627,29,40,.725,3,11,.273,23,35,.657,9,28,37,18,11,5,20,17,90,False,147,Indiana
12,School Totals,225,23,56,.411,13,34,.382,10,22,.455,24,30,.800,12,29,41,11,3,6,22,22,80,False,148,Indiana
12,School Totals,200,19,48,.396,14,38,.368,5,10,.500,13,20,.650,9,22,31,8,6,1,15,12,56,False,149,Indiana
11,School Totals,200,21,58,.362,13,38,.342,8,20,.400,29,35,.829,15,17,32,13,3,4,12,19,79,False,150,Indiana
13,School Totals,200,32,62,.516,28,48,.583,4,14,.286,7,10,.700,9,22,31,14,5,5,8,12,75,False,151,Indiana
11,School Totals,200,15,60,.250,11,42,.262,4,18,.222,13,17,.765,13,27,40,6,5,2,9,19,47,False,152,Indiana
13,School Totals,200,20,46,.435,16,36,.444,4,10,.400,22,26,.846,7,22,29,9,9,3,17,23,66,False,153,Indiana
13,School Totals,200,20,49,.408,17,37,.459,3,12,.250,13,19,.684,8,32,40,10,5,3,13,10,56,False,154,Indiana
14,School Totals,200,20,44,.455,15,29,.517,5,15,.333,10,14,.714,7,20,27,11,6,0,17,18,55,False,155,Indiana
13,School Totals,200,23,43,.535,15,30,.500,8,13,.615,9,15,.600,9,21,30,6,5,2,12,15,63,False,156,Indiana
10,School Totals,200,22,50,.440,17,36,.472,5,14,.357,11,16,.688,7,23,30,8,7,8,15,13,60,False,157,Indiana
11,School Totals,200,21,41,.512,16,28,.571,5,13,.385,18,24,.750,5,22,27,14,4,7,18,14,65,False,158,Indiana
15,School Totals,200,19,59,.322,11,36,.306,8,23,.348,18,24,.750,11,21,32,8,6,3,14,22,64,False,159,Indiana
11,School Totals,200,24,51,.471,20,36,.556,4,15,.267,9,18,.500,10,18,28,10,6,1,7,18,61,False,160,Indiana
12,School Totals,200,24,57,.421,16,39,.410,8,18,.444,2,3,.667,10,21,31,5,2,3,10,20,58,False,161,Indiana
13,School Totals,200,30,58,.517,24,43,.558,6,15,.400,27,38,.711,6,22,28,16,11,4,15,22,93,False,162,Indiana
11,School Totals,200,24,50,.480,17,32,.531,7,18,.389,17,21,.810,4,28,32,16,9,5,18,22,72,False,163,Indiana
11,School Totals,200,22,60,.367,17,39,.436,5,21,.238,11,17,.647,10,22,32,11,3,3,9,18,60,False,164,Indiana
11,School Totals,200,29,49,.592,22,31,.710,7,18,.389,15,17,.882,6,19,25,17,3,3,15,23,80,False,165,Indiana
11,School Totals,200,18,51,.353,12,31,.387,6,20,.300,12,15,.800,9,19,28,15,3,4,16,18,54,False,166,Indiana
12,School Totals,200,39,59,.661,28,36,.778,11,23,.478,27,37,.730,15,37,52,20,9,3,19,17,116,False,167,Indiana
10,School Totals,200,32,56,.571,22,41,.537,10,15,.667,9,16,.563,7,23,30,17,8,9,13,16,83,False,168,Indiana
10,School Totals,200,21,58,.362,9,25,.360,12,33,.364,20,25,.800,7,18,25,16,6,1,6,17,74,False,169,Indiana
11,School Totals,200,30,59,.508,21,39,.538,9,20,.450,16,24,.667,12,22,34,13,5,1,9,12,85,False,170,Indiana
10,School Totals,200,28,59,.475,21,41,.512,7,18,.389,23,29,.793,10,20,30,15,6,2,13,22,86,False,171,Indiana
11,School Totals,200,28,56,.500,19,32,.594,9,24,.375,22,29,.759,12,25,37,13,8,3,13,10,87,False,172,Indiana
12,School Totals,200,33,61,.541,26,44,.591,7,17,.412,8,13,.615,12,23,35,17,5,3,8,17,81,False,173,Indiana
15,School Totals,200,31,54,.574,21,33,.636,10,21,.476,23,25,.920,11,29,40,21,8,4,14,16,95,False,174,Indiana
15,School Totals,200,29,61,.475,21,41,.512,8,20,.400,8,14,.571,8,22,30,14,6,3,19,19,74,False,175,Indiana
14,School Totals,200,33,75,.440,23,45,.511,10,30,.333,18,27,.667,17,31,48,15,2,5,4,16,94,False,176,Indiana
11,School Totals,200,30,71,.423,22,54,.407,8,17,.471,14,19,.737,12,33,45,11,6,6,11,17,82,False,177,Indiana
14,School Totals,200,29,53,.547,22,32,.688,7,21,.333,14,24,.583,7,30,37,15,3,7,12,14,79,False,178,Indiana
11,School Totals,225,28,61,.459,15,30,.500,13,31,.419,18,22,.818,8,26,34,15,7,4,16,21,87,False,179,Indiana
11,School Totals,200,27,60,.450,20,36,.556,7,24,.292,9,17,.529,10,32,42,13,2,2,11,17,70,False,180,Indiana
11,School Totals,200,17,60,.283,12,36,.333,5,24,.208,11,13,.846,8,16,24,8,4,1,6,13,50,False,181,Indiana
10,School Totals,200,22,55,.400,18,37,.486,4,18,.222,21,28,.750,14,30,44,9,2,7,14,24,69,False,182,Indiana
11,School Totals,200,26,55,.473,17,34,.500,9,21,.429,15,21,.714,6,22,28,16,4,1,9,16,76,False,183,Indiana
11,School Totals,200,27,56,.482,16,31,.516,11,25,.440,15,20,.750,8,21,29,16,5,2,9,14,80,False,184,Indiana
12,School Totals,200,30,50,.600,15,28,.536,15,22,.682,14,18,.778,3,23,26,12,4,3,10,19,89,False,185,Indiana
10,School Totals,200,26,50,.520,14,25,.560,12,25,.480,6,8,.750,6,16,22,9,1,0,15,17,70,False,186,Indiana
11,School Totals,200,25,66,.379,21,47,.447,4,19,.211,13,18,.722,13,13,26,8,9,2,11,26,67,False,187,Indiana
10,School Totals,200,25,53,.472,17,34,.500,8,19,.421,14,19,.737,12,20,32,14,6,3,10,10,72,False,188,Indiana
9,School Totals,200,28,57,.491,15,33,.455,13,24,.542,9,11,.818,7,15,22,11,2,1,11,23,78,False,189,Indiana
11,School Totals,200,24,49,.490,17,32,.531,7,17,.412,15,20,.750,11,19,30,11,5,4,14,17,70,False,190,Indiana
9,School Totals,200,25,67,.373,15,42,.357,10,25,.400,6,10,.600,11,17,28,12,3,2,6,15,66,False,191,Indiana
12,School Totals,200,32,54,.593,14,22,.636,18,32,.563,8,9,.889,9,24,33,23,5,1,17,16,90,False,192,Indiana
11,School Totals,200,24,55,.436,19,39,.487,5,16,.313,10,16,.625,5,14,19,15,9,3,8,17,63,False,193,Indiana
16,School Totals,200,31,58,.534,21,31,.677,10,27,.370,12,20,.600,9,32,41,16,3,4,13,23,84,False,194,Indiana
11,School Totals,200,23,63,.365,11,32,.344,12,31,.387,7,16,.438,16,18,34,17,5,2,4,17,65,False,195,Indiana
12,School Totals,200,23,60,.383,13,35,.371,10,25,.400,7,11,.636,11,21,32,12,4,2,12,21,63,False,196,Indiana
10,School Totals,200,24,52,.462,15,28,.536,9,24,.375,15,20,.750,5,27,32,11,3,2,14,21,72,False,197,Indiana
11,School Totals,200,27,65,.415,16,33,.485,11,32,.344,6,10,.600,16,19,35,19,5,6,8,15,71,False,198,Indiana
10,School Totals,200,22,62,.355,15,38,.395,7,24,.292,18,22,.818,16,17,33,9,7,6,9,24,69,False,199,Indiana
11,School Totals,200,24,59,.407,13,37,.351,11,22,.500,17,20,.850,12,23,35,10,3,3,13,26,76,False,200,Indiana
15,School Totals,200,32,61,.525,23,34,.676,9,27,.333,15,25,.600,21,30,51,15,9,3,15,23,88,False,201,Indiana
14,School Totals,200,40,60,.667,24,33,.727,16,27,.593,6,10,.600,5,24,29,25,14,3,20,15,102,False,202,Indiana
12,School Totals,200,35,70,.500,25,42,.595,10,28,.357,6,9,.667,13,27,40,18,6,5,16,21,86,False,203,Indiana
11,School Totals,200,26,60,.433,16,31,.516,10,29,.345,16,22,.727,10,18,28,17,9,6,14,15,78,False,204,Indiana
10,School Totals,200,30,52,.577,22,33,.667,8,19,.421,15,24,.625,8,24,32,19,7,3,16,19,83,False,205,Indiana
11,School Totals,200,24,52,.462,13,32,.406,11,20,.550,10,19,.526,5,30,35,17,7,4,18,20,69,False,206,Indiana
14,School Totals,200,39,58,.672,24,32,.750,15,26,.577,19,25,.760,11,25,36,24,12,5,12,15,112,False,207,Indiana
11,School Totals,200,27,53,.509,20,36,.556,7,17,.412,13,17,.765,5,14,19,13,5,4,9,16,74,False,208,Indiana
14,School Totals,200,30,53,.566,25,38,.658,5,15,.333,27,36,.750,12,22,34,11,7,7,13,25,92,False,209,Indiana
13,School Totals,200,29,56,.518,20,34,.588,9,22,.409,23,30,.767,10,38,48,13,6,7,17,23,90,False,210,Indiana
15,School Totals,200,40,78,.513,27,50,.540,13,28,.464,12,16,.750,18,26,44,21,9,6,8,17,105,False,211,Indiana
10,School Totals,200,27,63,.429,17,43,.395,10,20,.500,16,23,.696,19,21,40,13,5,3,12,11,80,False,212,Indiana
13,School Totals,200,33,51,.647,22,32,.688,11,19,.579,22,31,.710,11,20,31,18,4,6,12,16,99,False,213,Indiana
11,School Totals,200,28,59,.475,18,35,.514,10,24,.417,13,20,.650,15,23,38,15,10,3,23,17,79,False,214,Indiana
10,School Totals,200,28,51,.549,19,33,.576,9,18,.500,14,23,.609,5,26,31,16,6,4,14,19,79,False,215,Indiana
11,School Totals,200,21,43,.488,14,26,.538,7,17,.412,10,10,1.000,3,22,25,13,7,4,18,21,59,False,216,Indiana
13,School Totals,200,31,67,.463,20,37,.541,11,30,.367,12,18,.667,15,33,48,19,9,1,12,18,85,False,217,Indiana
11,School Totals,200,26,63,.413,18,38,.474,8,25,.320,10,12,.833,8,26,34,14,6,5,13,22,70,False,218,Indiana
15,School Totals,200,37,65,.569,18,29,.621,19,36,.528,10,13,.769,12,26,38,27,9,3,11,20,103,False,219,Indiana
15,School Totals,200,30,57,.526,17,29,.586,13,28,.464,16,20,.800,10,28,38,21,6,3,9,13,89,False,220,Indiana
12,School Totals,225,28,62,.452,21,46,.457,7,16,.438,16,18,.889,10,19,29,6,8,3,19,31,79,False,221,Indiana
10,School Totals,200,26,57,.456,24,39,.615,2,18,.111,20,26,.769,10,29,39,12,2,6,11,16,74,False,222,Indiana
14,School Totals,200,33,66,.500,23,36,.639,10,30,.333,4,8,.500,11,28,39,18,6,5,12,17,80,False,223,Indiana
10,School Totals,200,17,47,.362,8,20,.400,9,27,.333,20,26,.769,6,28,34,12,5,2,15,18,63,False,224,Indiana
11,School Totals,200,29,63,.460,20,38,.526,9,25,.360,18,21,.857,18,18,36,14,7,3,10,18,85,False,225,Indiana
12,School Totals,200,26,69,.377,15,39,.385,11,30,.367,6,10,.600,14,18,32,20,3,5,10,14,69,False,226,Indiana
13,School Totals,200,27,51,.529,18,30,.600,9,21,.429,17,23,.739,8,24,32,15,4,2,12,17,80,False,227,Indiana
12,School Totals,200,28,59,.475,16,31,.516,12,28,.429,9,13,.692,8,17,25,14,8,1,4,20,77,False,228,Indiana
11,School Totals,200,27,55,.491,14,23,.609,13,32,.406,7,7,1.000,9,26,35,13,6,3,12,11,74,False,229,Indiana
10,School Totals,200,30,59,.508,19,37,.514,11,22,.500,10,20,.500,11,27,38,13,5,2,13,25,81,False,230,Indiana
13,School Totals,200,26,51,.510,18,30,.600,8,21,.381,20,25,.800,9,21,30,12,9,3,9,12,80,False,231,Indiana
11,School Totals,200,24,53,.453,20,36,.556,4,17,.235,17,21,.810,9,20,29,13,6,7,14,17,69,False,232,Indiana
12,School Totals,200,37,57,.649,27,40,.675,10,17,.588,15,18,.833,7,22,29,23,10,5,12,16,99,False,233,Indiana
11,School Totals,200,25,52,.481,19,31,.613,6,21,.286,17,23,.739,6,23,29,13,5,4,11,22,73,False,234,Indiana
13,School Totals,200,25,61,.410,12,30,.400,13,31,.419,23,26,.885,12,16,28,13,2,1,12,27,86,False,235,Indiana
11,School Totals,225,31,71,.437,16,40,.400,15,31,.484,26,36,.722,17,27,44,15,7,3,17,31,103,False,236,Indiana
15,School Totals,200,40,71,.563,29,44,.659,11,27,.407,9,14,.643,16,27,43,23,10,6,16,21,100,False,237,Indiana
15,School Totals,200,28,46,.609,19,25,.760,9,21,.429,22,31,.710,9,43,52,16,5,5,26,19,87,False,238,Indiana
12,School Totals,225,25,62,.403,18,38,.474,7,24,.292,11,19,.579,11,27,38,12,4,3,15,13,68,False,239,Indiana
14,School Totals,200,29,59,.492,20,34,.588,9,25,.360,18,22,.818,14,32,46,20,4,8,15,13,85,False,240,Indiana
11,School Totals,200,25,52,.481,17,31,.548,8,21,.381,18,27,.667,7,29,36,12,7,6,13,22,76,False,241,Indiana
14,School Totals,200,28,60,.467,21,38,.553,7,22,.318,20,23,.870,12,29,41,15,7,8,13,20,83,False,242,Indiana
13,School Totals,200,29,56,.518,22,36,.611,7,20,.350,18,24,.750,12,30,42,16,10,8,15,15,83,False,243,Indiana
14,School Totals,200,33,60,.550,21,32,.656,12,28,.429,25,32,.781,11,33,44,19,9,5,12,18,103,False,244,Indiana
12,School Totals,200,26,59,.441,20,38,.526,6,21,.286,20,26,.769,12,26,38,11,3,8,13,18,78,False,245,Indiana
15,School Totals,200,42,63,.667,31,37,.838,11,26,.423,8,14,.571,10,30,40,28,9,8,9,13,103,False,246,Indiana
13,School Totals,200,35,56,.625,20,30,.667,15,26,.577,12,16,.750,8,27,35,22,7,2,16,18,97,False,247,Indiana
11,School Totals,200,28,65,.431,17,40,.425,11,25,.440,16,24,.667,19,21,40,15,8,7,19,22,83,False,248,Indiana
11,School Totals,200,19,59,.322,15,38,.395,4,21,.190,20,29,.690,15,20,35,8,6,2,13,17,62,False,249,Indiana
11,School Totals,200,26,49,.531,21,34,.618,5,15,.333,11,15,.733,7,23,30,9,5,2,13,16,68,False,250,Indiana
12,School Totals,200,29,49,.592,16,24,.667,13,25,.520,25,31,.806,7,22,29,22,4,4,12,28,96,False,251,Indiana
11,School Totals,200,27,64,.422,17,41,.415,10,23,.435,8,9,.889,10,21,31,9,5,6,14,16,72,False,252,Indiana
13,School Totals,200,29,62,.468,25,40,.625,4,22,.182,14,18,.778,6,21,27,14,14,6,11,22,76,False,253,Indiana
11,School Totals,200,30,61,.492,21,36,.583,9,25,.360,9,15,.600,11,24,35,11,5,5,15,23,78,False,254,Indiana
10,School Totals,200,29,59,.492,18,35,.514,11,24,.458,13,16,.813,11,19,30,12,4,3,9,20,82,False,255,Indiana
12,School Totals,200,24,44,.545,17,31,.548,7,13,.538,5,8,.625,2,15,17,10,2,2,15,20,60,False,256,Indiana
11,School Totals,200,17,53,.321,9,32,.281,8,21,.381,13,22,.591,8,22,30,10,5,4,13,16,55,False,257,Indiana
10,School Totals,275,41,78,.526,35,57,.614,6,21,.286,22,32,.688,13,42,55,13,10,7,23,24,110,False,258,Indiana
10,School Totals,200,21,49,.429,14,29,.483,7,20,.350,11,12,.917,7,21,28,11,7,0,14,22,60,False,259,Indiana
11,School Totals,200,22,57,.386,14,33,.424,8,24,.333,12,16,.750,10,24,34,11,6,2,14,21,64,False,260,Indiana
11,School Totals,200,25,51,.490,21,32,.656,4,19,.211,9,14,.643,8,23,31,10,4,4,15,21,63,False,261,Indiana
11,School Totals,200,26,75,.347,19,48,.396,7,27,.259,15,18,.833,16,30,46,11,6,5,14,24,74,False,262,Indiana
11,School Totals,225,32,68,.471,22,39,.564,10,29,.345,16,19,.842,14,22,36,18,10,4,20,35,90,False,263,Indiana
12,School Totals,200,22,55,.400,14,31,.452,8,24,.333,11,16,.688,12,28,40,12,4,1,16,15,63,False,264,Indiana
13,School Totals,200,27,61,.443,19,39,.487,8,22,.364,13,17,.765,13,21,34,14,5,3,14,28,75,False,265,Indiana
10,School Totals,200,34,58,.586,22,35,.629,12,23,.522,16,22,.727,5,23,28,18,5,4,11,22,96,False,266,Indiana
11,School Totals,200,35,58,.603,23,38,.605,12,20,.600,13,19,.684,4,32,36,17,6,8,15,17,95,False,267,Indiana
11,School Totals,200,23,56,.411,14,34,.412,9,22,.409,5,9,.556,11,23,34,7,2,6,10,14,60,False,268,Indiana
10,School Totals,200,22,58,.379,17,39,.436,5,19,.263,14,18,.778,10,21,31,17,4,2,14,18,63,False,269,Indiana
11,School Totals,200,21,45,.467,17,27,.630,4,18,.222,23,33,.697,8,17,25,12,10,3,19,18,69,False,270,Indiana
11,School Totals,200,33,61,.541,25,39,.641,8,22,.364,12,29,.414,11,31,42,25,2,8,12,13,86,False,271,Indiana
11,School Totals,200,27,55,.491,21,37,.568,6,18,.333,8,12,.667,7,16,23,11,6,1,18,25,68,False,272,Indiana
11,School Totals,200,23,49,.469,18,32,.563,5,17,.294,19,25,.760,12,22,34,12,4,9,11,17,70,False,273,Indiana
10,School Totals,200,33,66,.500,28,48,.583,5,18,.278,16,21,.762,12,28,40,15,5,9,8,13,87,False,274,Indiana
12,School Totals,200,31,58,.534,19,37,.514,12,21,.571,13,18,.722,12,24,36,19,7,4,8,18,87,False,275,Indiana
11,School Totals,200,30,59,.508,25,38,.658,5,21,.238,16,26,.615,11,17,28,12,4,4,9,26,81,False,276,Indiana
12,School Totals,200,22,55,.400,20,48,.417,2,7,.286,9,14,.643,6,25,31,7,4,2,10,14,55,False,277,Indiana
14,School Totals,200,27,66,.409,19,45,.422,8,21,.381,15,23,.652,14,31,45,14,11,6,10,16,77,False,278,Indiana
11,School Totals,200,22,55,.400,17,32,.531,5,23,.217,13,19,.684,12,23,35,9,5,4,15,17,62,False,279,Indiana
11,School Totals,225,27,55,.491,19,34,.559,8,21,.381,18,25,.720,9,31,40,16,1,5,14,23,80,False,280,Indiana
11,School Totals,200,28,68,.412,24,44,.545,4,24,.167,12,19,.632,19,25,44,10,5,4,18,18,72,False,281,Indiana
14,School Totals,200,30,67,.448,22,43,.512,8,24,.333,19,25,.760,12,30,42,17,10,10,10,14,87,False,282,Indiana
15,School Totals,200,29,59,.492,24,37,.649,5,22,.227,16,27,.593,12,26,38,20,12,5,15,19,79,False,283,Indiana
11,School Totals,200,24,50,.480,20,35,.571,4,15,.267,9,10,.900,7,14,21,9,7,3,12,22,61,False,284,Indiana
9,School Totals,200,28,70,.400,20,51,.392,8,19,.421,11,15,.733,16,26,42,16,7,5,12,14,75,False,285,Indiana
10,School Totals,200,25,62,.403,19,35,.543,6,27,.222,18,22,.818,10,24,34,14,6,1,7,20,74,False,286,Indiana
13,School Totals,200,23,53,.434,15,30,.500,8,23,.348,12,22,.545,6,28,34,17,9,4,11,14,66,False,287,Indiana
11,School Totals,200,20,59,.339,12,33,.364,8,26,.308,9,14,.643,8,19,27,9,4,2,9,18,57,False,288,Indiana
10,School Totals,200,28,56,.500,22,38,.579,6,18,.333,9,16,.563,4,23,27,12,10,8,12,18,71,False,289,Indiana
10,School Totals,200,25,44,.568,20,29,.690,5,15,.333,16,29,.552,5,22,27,15,7,4,17,25,71,False,290,Indiana
9,School Totals,200,27,54,.500,24,38,.632,3,16,.188,10,17,.588,7,23,30,10,3,2,10,16,67,False,291,Indiana
9,School Totals,200,20,55,.364,14,36,.389,6,19,.316,10,18,.556,9,15,24,11,5,0,7,13,56,False,292,Indiana
10,School Totals,200,19,66,.288,15,47,.319,4,19,.211,18,25,.720,21,28,49,13,6,2,8,18,60,False,293,Indiana
12,School Totals,200,24,55,.436,15,35,.429,9,20,.450,8,18,.444,8,29,37,14,5,7,13,23,65,False,294,Indiana
13,School Totals,200,30,53,.566,24,37,.649,6,16,.375,14,23,.609,6,28,34,21,9,6,12,15,80,False,295,Indiana
10,School Totals,200,26,44,.591,20,30,.667,6,14,.429,20,29,.690,5,26,31,14,9,6,18,23,78,False,296,Indiana
10,School Totals,200,32,57,.561,18,33,.545,14,24,.583,6,9,.667,4,15,19,23,7,2,10,19,84,False,297,Indiana
10,School Totals,200,24,53,.453,21,39,.538,3,14,.214,6,9,.667,11,22,33,10,6,3,17,20,57,False,298,Indiana
10,School Totals,250,29,65,.446,22,49,.449,7,16,.438,13,23,.565,11,20,31,16,7,3,12,13,78,False,299,Indiana
10,School Totals,200,19,53,.358,13,29,.448,6,24,.250,25,29,.862,8,18,26,12,6,2,11,19,69,False,300,Indiana
15,School Totals,200,39,69,.565,32,48,.667,7,21,.333,19,33,.576,13,35,48,20,12,5,13,19,104,False,301,Indiana
17,School Totals,200,32,57,.561,26,36,.722,6,21,.286,10,19,.526,8,32,40,22,10,5,14,17,80,False,302,Indiana
14,School Totals,200,35,55,.636,26,35,.743,9,20,.450,17,23,.739,5,30,35,18,7,5,12,26,96,False,303,Indiana
9,School Totals,200,27,58,.466,19,38,.500,8,20,.400,10,15,.667,7,28,35,13,4,1,17,20,72,False,304,Indiana
8,School Totals,200,30,55,.545,28,43,.651,2,12,.167,16,23,.696,9,23,32,17,7,4,18,12,78,False,305,Indiana
9,School Totals,200,26,49,.531,16,32,.500,10,17,.588,14,21,.667,8,14,22,11,3,3,14,9,76,False,306,Indiana
13,School Totals,200,25,64,.391,20,48,.417,5,16,.313,14,25,.560,12,21,33,13,5,5,20,20,69,False,307,Indiana
10,School Totals,200,27,49,.551,24,38,.632,3,11,.273,11,19,.579,3,22,25,9,7,5,13,16,68,False,308,Indiana
11,School Totals,200,23,55,.418,16,37,.432,7,18,.389,11,14,.786,6,35,41,12,6,5,16,21,64,False,309,Indiana
10,School Totals,200,24,49,.490,20,35,.571,4,14,.286,16,25,.640,1,28,29,10,6,2,10,13,68,False,310,Indiana
10,School Totals,200,27,52,.519,18,31,.581,9,21,.429,8,10,.800,6,23,29,18,5,6,15,12,71,False,311,Indiana
16,School Totals,200,36,64,.563,27,40,.675,9,24,.375,5,10,.500,6,36,42,25,7,6,12,9,86,False,312,Indiana
14,School Totals,200,35,54,.648,27,34,.794,8,20,.400,16,26,.615,3,28,31,21,6,7,12,19,94,False,313,Indiana
10,School Totals,200,23,48,.479,21,36,.583,2,12,.167,25,35,.714,11,18,29,9,13,5,14,17,73,False,314,Indiana
9,School Totals,200,23,54,.426,18,40,.450,5,14,.357,12,16,.750,9,23,32,6,1,1,7,14,63,False,315,Indiana
10,School Totals,200,26,53,.491,19,36,.528,7,17,.412,16,16,1.000,3,21,24,11,2,1,7,21,75,False,316,Indiana
11,School Totals,200,19,52,.365,17,38,.447,2,14,.143,11,19,.579,8,21,29,7,9,6,13,12,51,False,317,Indiana
11,School Totals,200,22,51,.431,18,31,.581,4,20,.200,7,18,.389,9,23,32,12,7,6,13,15,55,False,318,Indiana
11,School Totals,200,23,60,.383,19,39,.487,4,21,.190,16,21,.762,10,25,35,15,1,4,12,22,66,False,319,Indiana
9,School Totals,200,16,58,.276,13,38,.342,3,20,.150,11,20,.550,10,27,37,4,6,4,9,15,46,False,320,Indiana
11,School Totals,200,21,60,.350,15,37,.405,6,23,.261,10,13,.769,7,23,30,7,10,4,11,24,58,False,321,Indiana
12,School Totals,225,28,72,.389,18,52,.346,10,20,.500,13,19,.684,14,28,42,21,3,7,11,21,79,False,322,Indiana
11,School Totals,200,26,53,.491,19,32,.594,7,21,.333,13,18,.722,8,22,30,17,7,3,12,15,72,False,323,Indiana
10,School Totals,200,21,53,.396,15,33,.455,6,20,.300,4,7,.571,6,20,26,11,8,1,9,12,52,False,324,Indiana
11,School Totals,200,20,53,.377,18,36,.500,2,17,.118,21,28,.750,7,23,30,8,7,10,12,19,63,False,325,Indiana
9,School Totals,200,15,55,.273,10,30,.333,5,25,.200,11,18,.611,14,29,43,7,3,5,16,12,46,False,326,Indiana
12,School Totals,225,26,63,.413,20,36,.556,6,27,.222,12,22,.545,12,24,36,10,9,8,11,21,70,False,327,Indiana
11,School Totals,250,26,64,.406,20,44,.455,6,20,.300,17,27,.630,10,34,44,11,7,4,12,24,75,False,328,Indiana
10,School Totals,200,23,61,.377,14,37,.378,9,24,.375,8,13,.615,12,16,28,14,10,2,8,10,63,False,329,Indiana
12,School Totals,200,36,65,.554,29,45,.644,7,20,.350,13,18,.722,10,21,31,17,6,3,6,18,92,False,330,Indiana
17,School Totals,200,31,58,.534,27,40,.675,4,18,.222,23,29,.793,6,26,32,12,6,3,5,25,89,False,331,Indiana
11,School Totals,200,27,62,.435,16,35,.457,11,27,.407,10,15,.667,9,19,28,18,9,6,17,18,75,False,332,Indiana
15,School Totals,200,35,68,.515,29,47,.617,6,21,.286,13,23,.565,10,30,40,18,4,4,7,15,89,False,333,Indiana
9,School Totals,200,21,51,.412,15,29,.517,6,22,.273,15,24,.625,8,27,35,13,6,4,12,17,63,False,334,Indiana
9,School Totals,200,25,65,.385,19,47,.404,6,18,.333,7,13,.538,6,24,30,12,7,4,9,16,63,False,335,Indiana
16,School Totals,200,38,65,.585,33,54,.611,5,11,.455,17,25,.680,14,31,45,18,6,6,11,12,98,False,336,Indiana
10,School Totals,199,30,60,.500,27,46,.587,3,14,.214,22,30,.733,14,23,37,11,4,4,10,22,85,False,337,Indiana
11,School Totals,200,23,46,.500,15,25,.600,8,21,.381,37,45,.822,7,20,27,12,6,9,13,23,91,False,338,Indiana
13,School Totals,200,35,65,.538,26,42,.619,9,23,.391,21,30,.700,15,32,47,21,11,6,12,25,100,False,339,Indiana
13,School Totals,200,31,55,.564,28,45,.622,3,10,.300,14,17,.824,6,24,30,19,8,2,8,13,79,False,340,Indiana
11,School Totals,200,27,56,.482,21,37,.568,6,19,.316,28,38,.737,9,27,36,13,7,4,17,15,88,False,341,Indiana
11,School Totals,200,24,58,.414,17,38,.447,7,20,.350,9,18,.500,16,28,44,12,6,7,17,15,64,False,342,Indiana
11,School Totals,200,25,45,.556,18,30,.600,7,15,.467,23,38,.605,10,23,33,10,5,4,18,19,80,False,343,Indiana
12,School Totals,200,21,50,.420,16,36,.444,5,14,.357,17,26,.654,10,18,28,12,3,3,12,19,64,False,344,Indiana
12,School Totals,200,21,57,.368,19,44,.432,2,13,.154,13,18,.722,8,18,26,14,11,3,13,15,57,False,345,Indiana
12,School Totals,225,32,68,.471,27,43,.628,5,25,.200,27,38,.711,16,34,50,14,5,6,14,14,96,False,346,Indiana
13,School Totals,200,25,61,.410,20,44,.455,5,17,.294,7,12,.583,10,26,36,14,5,4,11,13,62,False,347,Indiana
11,School Totals,200,25,59,.424,20,38,.526,5,21,.238,9,18,.500,11,28,39,12,4,3,14,17,64,False,348,Indiana
12,School Totals,200,22,61,.361,18,43,.419,4,18,.222,11,18,.611,13,25,38,7,3,6,14,21,59,False,349,Indiana
12,School Totals,200,20,54,.370,17,40,.425,3,14,.214,23,30,.767,14,25,39,11,9,4,14,13,66,False,350,Indiana
11,School Totals,200,20,49,.408,14,37,.378,6,12,.500,20,36,.556,4,27,31,10,11,4,10,19,66,False,351,Indiana
12,School Totals,200,19,60,.317,17,41,.415,2,19,.105,10,12,.833,10,25,35,6,4,2,14,17,50,False,352,Indiana
11,School Totals,200,31,61,.508,23,35,.657,8,26,.308,12,20,.600,8,34,42,21,2,8,15,17,82,False,353,Indiana
11,School Totals,200,26,57,.456,22,45,.489,4,12,.333,11,20,.550,7,20,27,12,6,2,8,15,67,False,354,Indiana
11,School Totals,200,30,57,.526,21,38,.553,9,19,.474,7,10,.700,9,23,32,22,0,2,6,17,76,False,355,Indiana
10,School Totals,200,19,57,.333,17,46,.370,2,11,.182,9,10,.900,7,33,40,9,3,3,16,17,49,False,356,Indiana
10,School Totals,200,19,42,.452,12,30,.400,7,12,.583,14,18,.778,4,18,22,10,4,5,12,12,59,False,357,Indiana
11,School Totals,200,22,51,.431,15,30,.500,7,21,.333,11,14,.786,7,20,27,15,2,5,14,22,62,False,358,Indiana
11,School Totals,200,28,61,.459,17,40,.425,11,21,.524,22,32,.688,13,23,36,16,11,5,16,20,89,False,359,Indiana
12,School Totals,200,28,61,.459,25,49,.510,3,12,.250,6,12,.500,7,14,21,7,1,3,7,18,65,False,360,Indiana
11,School Totals,200,24,54,.444,20,40,.500,4,14,.286,16,22,.727,7,31,38,15,4,5,9,18,68,False,361,Indiana
11,School Totals,200,23,54,.426,18,40,.450,5,14,.357,17,27,.630,8,26,34,7,10,2,12,22,68,False,362,Indiana
11,School Totals,200,15,59,.254,10,35,.286,5,24,.208,14,21,.667,15,18,33,6,7,4,12,18,49,False,363,Indiana
11,School Totals,200,24,59,.407,16,43,.372,8,16,.500,10,12,.833,10,24,34,12,4,5,10,19,66,False,364,Indiana
11,School Totals,200,30,59,.508,27,44,.614,3,15,.200,9,17,.529,7,26,33,14,7,1,10,12,72,False,365,Indiana
11,School Totals,199,20,58,.345,14,43,.326,6,15,.400,10,15,.667,11,24,35,9,6,1,7,13,56,False,366,Indiana
13,School Totals,200,35,66,.530,26,44,.591,9,22,.409,10,17,.588,8,39,47,23,4,12,10,17,89,False,367,Indiana
13,School Totals,200,37,65,.569,32,46,.696,5,19,.263,10,22,.455,9,23,32,22,9,4,8,11,89,False,368,Indiana
10,School Totals,200,28,62,.452,23,48,.479,5,14,.357,18,24,.750,14,25,39,16,7,4,8,22,79,False,369,Indiana
11,School Totals,200,11,46,.239,9,36,.250,2,10,.200,20,29,.690,6,23,29,6,2,4,13,17,44,False,370,Indiana
9,School Totals,200,27,51,.529,22,36,.611,5,15,.333,20,25,.800,5,27,32,20,2,8,13,19,79,False,371,Indiana
9,School Totals,225,21,57,.368,17,42,.405,4,15,.267,21,28,.750,13,27,40,10,4,3,14,17,67,False,372,Indiana
14,School Totals,200,28,56,.500,15,23,.652,13,33,.394,18,31,.581,5,39,44,17,10,7,17,20,87,False,373,Indiana
9,School Totals,200,25,47,.532,18,31,.581,7,16,.438,11,20,.550,3,25,28,19,6,8,14,17,68,False,374,Indiana
9,School Totals,200,25,52,.481,18,34,.529,7,18,.389,10,16,.625,8,18,26,11,7,2,16,14,67,False,375,Indiana
11,School Totals,200,23,58,.397,16,40,.400,7,18,.389,7,9,.778,2,24,26,9,6,4,7,15,60,False,376,Indiana
10,School Totals,225,32,56,.571,26,37,.703,6,19,.316,17,21,.810,4,21,25,15,5,8,12,18,87,False,377,Indiana
11,School Totals,200,22,59,.373,18,37,.486,4,22,.182,15,18,.833,10,27,37,10,4,3,9,13,63,False,378,Indiana
10,School Totals,250,30,62,.484,22,41,.537,8,21,.381,5,8,.625,1,30,31,19,2,7,13,19,73,False,379,Indiana
10,School Totals,200,30,65,.462,21,41,.512,9,24,.375,15,25,.600,12,27,39,14,4,3,6,14,84,False,380,Indiana
10,School Totals,200,25,57,.439,22,39,.564,3,18,.167,16,29,.552,8,22,30,14,8,2,8,27,69,False,381,Indiana
10,School Totals,200,26,53,.491,18,36,.500,8,17,.471,21,35,.600,7,21,28,15,6,4,8,20,81,False,382,Indiana
10,School Totals,200,24,56,.429,14,40,.350,10,16,.625,12,17,.706,5,20,25,14,6,2,11,13,70,False,383,Indiana
10,School Totals,225,22,54,.407,18,46,.391,4,8,.500,23,34,.676,9,25,34,12,6,4,13,28,71,False,384,Indiana
10,School Totals,200,23,64,.359,17,41,.415,6,23,.261,15,24,.625,12,27,39,15,8,5,9,19,67,False,385,Indiana
11,School Totals,250,22,62,.355,14,38,.368,8,24,.333,27,38,.711,11,29,40,17,9,2,13,18,79,False,386,Indiana
11,School Totals,200,21,50,.420,16,35,.457,5,15,.333,12,22,.545,11,14,25,13,3,0,14,20,59,False,387,Indiana
10,School Totals,200,26,45,.578,19,33,.576,7,12,.583,23,30,.767,9,22,31,15,2,1,16,23,82,False,388,Indiana
10,School Totals,200,25,57,.439,21,38,.553,4,19,.211,17,24,.708,9,19,28,14,10,3,10,16,71,False,389,Indiana
12,School Totals,200,22,61,.361,14,43,.326,8,18,.444,11,18,.611,9,25,34,15,7,0,13,10,63,False,390,Indiana
12,School Totals,200,20,52,.385,16,37,.432,4,15,.267,13,17,.765,7,19,26,8,4,3,11,15,57,False,391,Indiana
10,School Totals,200,18,55,.327,16,35,.457,2,20,.100,20,29,.690,10,26,36,9,6,3,8,24,58,False,392,Indiana
10,School Totals,200,20,52,.385,15,29,.517,5,23,.217,13,18,.722,4,17,21,13,6,3,11,16,58,False,393,Indiana
9,School Totals,200,21,56,.375,19,40,.475,2,16,.125,6,15,.400,9,20,29,14,6,4,9,14,50,False,394,Indiana
12,School Totals,200,38,75,.507,32,58,.552,6,17,.353,7,9,.778,11,26,37,27,15,5,12,17,89,False,395,Maryland
11,School Totals,200,28,65,.431,24,53,.453,4,12,.333,11,16,.688,12,24,36,13,12,6,14,10,71,False,396,Maryland
11,School Totals,200,30,53,.566,25,42,.595,5,11,.455,17,23,.739,4,25,29,23,11,2,10,14,82,False,397,Maryland
13,School Totals,200,31,66,.470,25,46,.543,6,20,.300,11,16,.688,14,26,40,17,6,11,10,15,79,False,398,Maryland
11,School Totals,200,19,53,.358,17,39,.436,2,14,.143,17,31,.548,8,23,31,10,9,2,9,18,57,False,399,Maryland
10,School Totals,200,27,56,.482,22,43,.512,5,13,.385,10,17,.588,9,17,26,9,10,3,9,20,69,False,400,Maryland
9,School Totals,200,26,55,.473,21,43,.488,5,12,.417,23,31,.742,10,29,39,15,8,6,18,19,80,False,6,Maryland
10,School Totals,200,28,53,.528,19,34,.559,9,19,.474,21,27,.778,7,23,30,14,7,4,19,23,86,False,401,Maryland
10,School Totals,200,29,62,.468,22,45,.489,7,17,.412,18,22,.818,10,27,37,18,2,6,9,15,83,False,402,Maryland
12,School Totals,200,33,58,.569,21,40,.525,12,18,.667,20,28,.714,8,29,37,22,12,6,9,16,98,False,403,Maryland
9,School Totals,200,32,69,.464,29,57,.509,3,12,.250,5,11,.455,12,27,39,21,8,9,11,13,72,False,404,Maryland
10,School Totals,200,30,68,.441,26,43,.605,4,25,.160,13,19,.684,13,24,37,13,3,6,8,18,77,False,405,Maryland
13,School Totals,200,36,66,.545,33,56,.589,3,10,.300,22,28,.786,14,35,49,16,12,8,16,19,97,False,406,Maryland
10,School Totals,200,29,62,.468,19,46,.413,10,16,.625,9,17,.529,15,18,33,14,3,3,11,12,77,False,407,Maryland
10,School Totals,225,28,70,.400,20,52,.385,8,18,.444,19,25,.760,18,22,40,18,8,2,15,20,83,False,408,Maryland
11,School Totals,200,28,57,.491,21,45,.467,7,12,.583,10,14,.714,6,20,26,17,12,7,9,18,73,False,409,Maryland
12,School Totals,200,40,72,.556,37,62,.597,3,10,.300,23,32,.719,17,32,49,16,10,8,10,14,106,False,410,Maryland
12,School Totals,200,29,54,.537,23,41,.561,6,13,.462,24,33,.727,11,24,35,16,5,1,9,16,88,False,411,Maryland
12,School Totals,200,28,55,.509,21,40,.525,7,15,.467,18,25,.720,10,18,28,19,7,1,11,18,81,False,412,Maryland
9,School Totals,200,18,52,.346,16,42,.381,2,10,.200,15,17,.882,6,28,34,8,10,7,26,22,53,False,413,Maryland
10,School Totals,200,26,61,.426,23,47,.489,3,14,.214,16,20,.800,14,20,34,13,6,6,11,12,71,False,414,Maryland
12,School Totals,200,35,68,.515,23,45,.511,12,23,.522,10,12,.833,8,25,33,26,9,6,13,14,92,False,415,Maryland
10,School Totals,200,23,61,.377,21,48,.438,2,13,.154,8,11,.727,14,20,34,10,4,6,14,18,56,False,416,Maryland
12,School Totals,200,36,64,.563,32,56,.571,4,8,.500,9,15,.600,12,26,38,22,6,4,13,19,85,False,417,Maryland
10,School Totals,200,25,58,.431,20,45,.444,5,13,.385,12,19,.632,8,28,36,13,5,4,7,14,67,False,418,Maryland
10,School Totals,200,28,65,.431,20,43,.465,8,22,.364,12,17,.706,12,23,35,16,5,2,9,16,76,False,419,Maryland
10,School Totals,200,32,59,.542,24,46,.522,8,13,.615,16,24,.667,8,18,26,20,7,5,10,15,88,False,420,Maryland
10,School Totals,250,37,83,.446,29,61,.475,8,22,.364,22,27,.815,15,25,40,23,10,4,11,24,104,False,421,Maryland
10,School Totals,200,28,56,.500,22,43,.512,6,13,.462,17,19,.895,7,27,34,14,1,5,11,17,79,False,422,Maryland
9,School Totals,200,23,55,.418,15,37,.405,8,18,.444,20,26,.769,15,16,31,14,7,3,9,14,74,False,423,Maryland
10,School Totals,200,25,67,.373,21,46,.457,4,21,.190,10,13,.769,15,13,28,10,16,2,12,20,64,False,424,Maryland
9,School Totals,200,32,68,.471,28,51,.549,4,17,.235,21,25,.840,15,32,47,18,2,4,10,20,89,False,425,Maryland
9,School Totals,200,29,66,.439,20,47,.426,9,19,.474,16,20,.800,8,13,21,20,8,0,6,14,83,False,426,Maryland
14,School Totals,200,35,62,.565,33,54,.611,2,8,.250,33,41,.805,13,30,43,23,9,9,29,20,105,False,427,Maryland
11,School Totals,200,34,66,.515,32,59,.542,2,7,.286,5,18,.278,13,18,31,17,11,3,18,18,75,False,428,Maryland
13,School Totals,200,29,61,.475,23,46,.500,6,15,.400,25,33,.758,14,32,46,9,8,4,14,24,89,False,429,Maryland
11,School Totals,200,27,56,.482,25,42,.595,2,14,.143,14,30,.467,6,19,25,12,5,6,8,28,70,False,430,Maryland
11,School Totals,200,29,67,.433,24,49,.490,5,18,.278,13,18,.722,15,24,39,15,5,4,16,22,76,False,431,Maryland
13,School Totals,200,27,58,.466,23,47,.489,4,11,.364,14,17,.824,18,21,39,12,5,4,13,9,72,False,432,Maryland
13,School Totals,200,30,65,.462,27,55,.491,3,10,.300,13,22,.591,16,31,47,17,5,11,13,13,76,False,433,Maryland
10,School Totals,200,23,47,.489,19,38,.500,4,9,.444,12,21,.571,9,31,40,17,7,9,17,15,62,False,434,Maryland
11,School Totals,200,24,56,.429,21,46,.457,3,10,.300,10,17,.588,7,23,30,12,6,2,14,16,61,False,435,Maryland
12,School Totals,200,35,67,.522,29,53,.547,6,14,.429,23,37,.622,17,31,48,24,6,7,15,10,99,False,436,Maryland
11,School Totals,200,32,65,.492,29,48,.604,3,17,.176,8,14,.571,11,23,34,19,6,5,9,14,75,False,437,Maryland
12,School Totals,200,30,53,.566,21,38,.553,9,15,.600,20,26,.769,8,27,35,18,9,10,12,12,89,False,438,Maryland
11,School Totals,200,33,62,.532,29,53,.547,4,9,.444,15,26,.577,11,25,36,21,11,6,16,18,85,False,439,Maryland
13,School Totals,200,38,73,.521,29,52,.558,9,21,.429,10,12,.833,13,32,45,27,9,6,9,9,95,False,440,Maryland
11,School Totals,200,26,66,.394,23,52,.442,3,14,.214,9,17,.529,15,25,40,17,5,8,16,23,64,False,441,Maryland
12,School Totals,200,26,68,.382,21,50,.420,5,18,.278,17,33,.515,19,26,45,18,10,6,10,18,74,False,442,Maryland
9,School Totals,200,27,56,.482,25,45,.556,2,11,.182,10,18,.556,8,21,29,19,10,2,14,17,66,False,443,Maryland
11,School Totals,200,20,56,.357,14,36,.389,6,20,.300,11,15,.733,9,19,28,12,4,1,16,16,57,False,444,Maryland
11,School Totals,200,24,48,.500,16,34,.471,8,14,.571,23,35,.657,9,21,30,16,3,1,10,13,79,False,445,Maryland
12,School Totals,200,27,50,.540,20,35,.571,7,15,.467,5,8,.625,2,25,27,14,8,2,11,14,66,False,446,Maryland
10,School Totals,200,25,56,.446,25,50,.500,0,6,.000,24,32,.750,10,26,36,11,9,2,13,14,74,False,447,Maryland
10,School Totals,200,20,50,.400,18,41,.439,2,9,.222,20,27,.741,9,19,28,12,3,1,11,20,62,False,448,Maryland
12,School Totals,200,35,76,.461,27,59,.458,8,17,.471,13,17,.765,16,21,37,27,9,3,7,15,91,False,449,Maryland
13,School Totals,200,39,72,.542,29,44,.659,10,28,.357,18,26,.692,20,31,51,28,8,2,12,12,106,False,450,Maryland
10,School Totals,200,27,64,.422,21,47,.447,6,17,.353,12,18,.667,12,20,32,15,4,3,14,17,72,False,451,Maryland
10,School Totals,200,29,59,.492,25,45,.556,4,14,.286,21,24,.875,4,26,30,16,4,4,15,21,83,False,452,Maryland
10,School Totals,200,32,55,.582,32,54,.593,0,1,.000,23,25,.920,8,21,29,20,7,2,11,15,87,False,453,Maryland
10,School Totals,200,25,48,.521,18,34,.529,7,14,.500,21,30,.700,6,23,29,18,7,4,16,14,78,False,454,Maryland
11,School Totals,200,30,73,.411,28,61,.459,2,12,.167,14,18,.778,14,28,42,12,9,4,13,20,76,False,455,Maryland
11,School Totals,200,21,62,.339,12,44,.273,9,18,.500,15,22,.682,17,20,37,16,8,1,11,19,66,False,456,Maryland
12,School Totals,200,21,47,.447,19,38,.500,2,9,.222,16,21,.762,6,22,28,13,2,10,11,15,60,False,457,Maryland
10,School Totals,200,26,58,.448,22,47,.468,4,11,.364,19,24,.792,7,36,43,13,5,5,15,16,75,False,458,Maryland
11,School Totals,200,26,58,.448,22,50,.440,4,8,.500,15,28,.536,13,19,32,17,5,3,13,22,71,False,459,Maryland
10,School Totals,200,25,52,.481,25,43,.581,0,9,.000,21,30,.700,11,23,34,7,7,5,13,16,71,False,460,Maryland
13,School Totals,200,13,49,.265,11,37,.297,2,12,.167,14,25,.560,9,19,28,8,3,5,9,19,42,False,461,Maryland
9,School Totals,200,27,55,.491,16,34,.471,11,21,.524,13,24,.542,13,24,37,10,3,2,8,18,78,False,462,Maryland
14,School Totals,200,24,52,.462,18,32,.563,6,20,.300,9,17,.529,13,21,34,9,1,5,26,21,63,False,463,Maryland
10,School Totals,200,23,52,.442,19,39,.487,4,13,.308,23,39,.590,10,23,33,13,7,4,16,18,73,False,464,Maryland
10,School Totals,200,21,50,.420,16,31,.516,5,19,.263,15,25,.600,10,17,27,5,2,3,11,16,62,False,465,Maryland
11,School Totals,200,23,54,.426,16,44,.364,7,10,.700,25,35,.714,15,22,37,9,1,2,8,16,78,False,466,Maryland
10,School Totals,200,25,50,.500,23,43,.535,2,7,.286,25,35,.714,8,21,29,13,5,6,11,14,77,False,467,Maryland
10,School Totals,200,21,50,.420,20,40,.500,1,10,.100,22,32,.688,13,18,31,9,7,6,12,13,65,False,468,Maryland
9,School Totals,200,21,57,.368,18,44,.409,3,13,.231,20,32,.625,18,22,40,14,2,9,7,19,65,False,469,Maryland
10,School Totals,200,29,57,.509,20,38,.526,9,19,.474,16,22,.727,12,36,48,19,2,9,16,15,83,False,470,Maryland
16,School Totals,200,27,53,.509,18,36,.500,9,17,.529,12,20,.600,12,27,39,14,5,3,17,11,75,False,471,Maryland
10,School Totals,200,24,52,.462,20,33,.606,4,19,.211,18,23,.783,10,22,32,15,4,4,15,14,70,False,472,Maryland
10,School Totals,200,26,60,.433,17,39,.436,9,21,.429,13,21,.619,11,18,29,12,5,4,15,18,74,False,473,Maryland
10,School Totals,200,21,60,.350,17,45,.378,4,15,.267,24,37,.649,18,22,40,10,3,5,8,16,70,False,474,Maryland
10,School Totals,200,18,54,.333,12,40,.300,6,14,.429,19,23,.826,11,25,36,9,5,5,13,11,61,False,475,Maryland
10,School Totals,200,24,48,.500,19,33,.576,5,15,.333,17,27,.630,7,19,26,10,2,3,15,19,70,False,476,Maryland
10,School Totals,200,22,48,.458,18,32,.563,4,16,.250,12,21,.571,6,22,28,8,4,1,16,14,60,False,477,Maryland
10,School Totals,200,23,57,.404,19,44,.432,4,13,.308,11,21,.524,12,16,28,12,2,3,8,18,61,False,478,Maryland
10,School Totals,200,22,47,.468,15,30,.500,7,17,.412,22,32,.688,7,26,33,7,4,2,16,19,73,False,479,Maryland
12,School Totals,250,27,67,.403,21,39,.538,6,28,.214,26,35,.743,11,29,40,11,8,5,19,22,86,False,480,Maryland
10,School Totals,200,25,61,.410,21,44,.477,4,17,.235,20,27,.741,12,25,37,7,5,7,13,23,74,False,481,Maryland
10,School Totals,200,23,47,.489,15,36,.417,8,11,.727,10,17,.588,6,26,32,14,7,2,15,17,64,False,482,Maryland
10,School Totals,200,19,51,.373,18,37,.486,1,14,.071,16,22,.727,7,26,33,8,5,4,13,21,55,False,483,Maryland
9,School Totals,200,28,56,.500,20,40,.500,8,16,.500,17,22,.773,7,29,36,15,6,8,13,20,81,False,484,Maryland
15,School Totals,200,14,52,.269,7,33,.212,7,19,.368,9,16,.563,10,22,32,3,4,0,15,17,44,False,485,Maryland
10,School Totals,200,26,57,.456,22,42,.524,4,15,.267,19,22,.864,11,24,35,15,4,4,9,15,75,False,486,Maryland
11,School Totals,200,19,55,.345,12,41,.293,7,14,.500,16,22,.727,12,19,31,7,3,4,10,20,61,False,487,Maryland
15,School Totals,200,23,63,.365,18,43,.419,5,20,.250,13,21,.619,12,26,38,8,1,5,17,25,64,False,488,Maryland
12,School Totals,225,25,62,.403,17,45,.378,8,17,.471,14,26,.538,9,24,33,10,7,3,12,21,72,False,489,Maryland
15,School Totals,200,31,57,.544,26,42,.619,5,15,.333,15,20,.750,11,25,36,18,8,5,12,17,82,False,490,Maryland
12,School Totals,200,24,62,.387,16,38,.421,8,24,.333,13,21,.619,8,21,29,10,5,6,13,18,69,False,491,Maryland
11,School Totals,200,25,75,.333,22,56,.393,3,19,.158,16,21,.762,23,23,46,17,6,5,11,23,69,False,492,Maryland
15,School Totals,200,23,47,.489,19,35,.543,4,12,.333,17,29,.586,13,24,37,14,6,6,20,11,67,False,493,Maryland
11,School Totals,200,35,62,.565,27,50,.540,8,12,.667,13,20,.650,9,31,40,28,5,10,15,16,91,False,494,Maryland
11,School Totals,200,29,56,.518,26,41,.634,3,15,.200,22,32,.688,19,24,43,18,4,3,12,12,83,False,495,Maryland
11,School Totals,200,27,55,.491,22,39,.564,5,16,.313,11,17,.647,15,30,45,20,1,5,17,10,70,False,496,Maryland
11,School Totals,200,29,55,.527,24,42,.571,5,13,.385,14,17,.824,10,32,42,15,3,2,14,19,77,False,497,Maryland
11,School Totals,200,22,49,.449,20,38,.526,2,11,.182,23,39,.590,12,33,45,14,5,5,19,17,69,False,498,Maryland
15,School Totals,200,38,62,.613,28,42,.667,10,20,.500,14,22,.636,10,32,42,27,8,4,15,13,100,False,499,Maryland
15,School Totals,200,19,51,.373,14,29,.483,5,22,.227,18,22,.818,14,24,38,16,4,4,11,12,61,False,500,Maryland
15,School Totals,200,25,43,.581,19,24,.792,6,19,.316,15,19,.789,7,36,43,19,5,9,22,13,71,False,501,Maryland
11,School Totals,200,28,53,.528,19,35,.543,9,18,.500,11,16,.688,6,27,33,17,0,4,11,12,76,False,502,Maryland
14,School Totals,200,33,58,.569,31,49,.633,2,9,.222,11,17,.647,13,22,35,19,9,3,10,13,79,False,503,Maryland
14,School Totals,200,29,53,.547,21,36,.583,8,17,.471,15,19,.789,10,24,34,16,4,2,14,8,81,False,504,Maryland
11,School Totals,200,31,60,.517,21,37,.568,10,23,.435,22,28,.786,12,28,40,18,2,4,11,17,94,False,505,Maryland
11,School Totals,200,22,60,.367,14,38,.368,8,22,.364,10,14,.714,11,28,39,13,3,2,18,21,62,False,506,Maryland
12,School Totals,200,18,57,.316,15,42,.357,3,15,.200,8,18,.444,8,33,41,4,6,6,14,16,47,False,507,Maryland
11,School Totals,200,21,61,.344,18,43,.419,3,18,.167,6,8,.750,8,29,37,10,4,3,13,13,51,False,508,Maryland
11,School Totals,200,21,53,.396,20,41,.488,1,12,.083,9,14,.643,10,29,39,5,7,4,21,17,52,False,509,Maryland
11,School Totals,200,25,59,.424,18,42,.429,7,17,.412,7,12,.583,10,27,37,15,3,2,14,17,64,False,510,Maryland
11,School Totals,200,25,60,.417,20,42,.476,5,18,.278,9,16,.563,16,26,42,10,1,5,14,16,64,False,511,Maryland
10,School Totals,200,26,53,.491,20,38,.526,6,15,.400,13,18,.722,9,21,30,11,4,1,16,22,71,False,512,Maryland
14,School Totals,200,35,52,.673,24,36,.667,11,16,.688,5,9,.556,5,37,42,21,3,7,19,16,86,False,513,Maryland
11,School Totals,200,21,52,.404,13,31,.419,8,21,.381,10,23,.435,15,29,44,14,4,4,14,17,60,False,514,Maryland
11,School Totals,200,27,58,.466,22,41,.537,5,17,.294,10,18,.556,10,17,27,14,9,6,13,17,69,False,515,Maryland
10,School Totals,200,27,45,.600,23,32,.719,4,13,.308,25,34,.735,8,30,38,11,7,6,26,25,83,False,516,Maryland
11,School Totals,200,20,56,.357,10,29,.345,10,27,.370,8,11,.727,7,22,29,12,4,4,12,23,58,False,517,Maryland
11,School Totals,200,30,63,.476,24,48,.500,6,15,.400,6,16,.375,14,23,37,19,7,4,8,15,72,False,518,Maryland
11,School Totals,200,27,63,.429,23,44,.523,4,19,.211,10,14,.714,6,21,27,14,9,1,14,20,68,False,519,Maryland
11,School Totals,200,28,59,.475,25,45,.556,3,14,.214,8,13,.615,9,28,37,10,11,6,19,24,67,False,520,Maryland
11,School Totals,200,27,63,.429,24,40,.600,3,23,.130,11,15,.733,13,20,33,9,7,4,14,18,68,False,521,Maryland
10,School Totals,225,20,61,.328,14,41,.341,6,20,.300,12,17,.706,8,32,40,10,4,3,12,21,58,False,522,Maryland
11,School Totals,200,23,48,.479,16,33,.485,7,15,.467,22,29,.759,4,29,33,13,8,3,12,19,75,False,523,Maryland
10,School Totals,200,26,51,.510,18,31,.581,8,20,.400,23,25,.920,7,29,36,18,3,1,14,14,83,False,524,Maryland
11,School Totals,200,25,61,.410,17,40,.425,8,21,.381,18,26,.692,11,27,38,14,4,0,10,20,76,False,525,Maryland
13,School Totals,200,31,59,.525,23,39,.590,8,20,.400,16,19,.842,12,25,37,17,5,8,15,18,86,False,526,Maryland
11,School Totals,200,22,48,.458,19,36,.528,3,12,.250,15,19,.789,5,23,28,6,9,2,13,15,62,False,527,Maryland
9,School Totals,200,23,46,.500,16,31,.516,7,15,.467,5,10,.500,8,24,32,11,8,8,17,15,58,False,528,Maryland
10,School Totals,200,23,57,.404,18,42,.429,5,15,.333,9,16,.563,12,21,33,12,3,10,16,18,60,False,529,Maryland
10,School Totals,200,24,57,.421,16,38,.421,8,19,.421,21,28,.750,11,17,28,15,5,0,13,17,77,False,530,Maryland
12,School Totals,200,26,53,.491,22,35,.629,4,18,.222,11,17,.647,12,26,38,12,9,10,17,8,67,False,531,Maryland
11,School Totals,200,30,71,.423,22,49,.449,8,22,.364,15,24,.625,20,15,35,11,8,4,15,21,83,False,532,Maryland
15,School Totals,200,24,55,.436,17,40,.425,7,15,.467,13,25,.520,10,28,38,13,8,4,14,22,68,False,533,Maryland
9,School Totals,200,29,60,.483,23,42,.548,6,18,.333,16,25,.640,13,23,36,12,9,2,8,19,80,False,534,Maryland
9,School Totals,200,21,58,.362,17,45,.378,4,13,.308,10,18,.556,8,30,38,8,6,3,11,19,56,False,535,Maryland
13,School Totals,200,33,53,.623,20,33,.606,13,20,.650,10,22,.455,11,29,40,26,7,4,18,19,89,False,536,Maryland
11,School Totals,200,25,64,.391,23,46,.500,2,18,.111,8,13,.615,17,23,40,6,4,3,14,23,60,False,537,Maryland
11,School Totals,200,25,64,.391,20,45,.444,5,19,.263,20,26,.769,16,17,33,7,11,5,17,24,75,False,538,Maryland
10,School Totals,200,32,58,.552,24,36,.667,8,22,.364,16,22,.727,9,15,24,6,5,4,11,22,88,False,539,Maryland
10,School Totals,200,25,63,.397,18,43,.419,7,20,.350,9,12,.750,16,22,38,18,6,8,9,10,66,False,540,Maryland
11,School Totals,200,28,58,.483,22,43,.512,6,15,.400,15,26,.577,11,30,41,15,5,7,17,27,77,False,541,Maryland
11,School Totals,200,26,60,.433,16,35,.457,10,25,.400,23,35,.657,10,26,36,10,3,7,10,13,85,False,542,Maryland
16,School Totals,200,22,49,.449,14,30,.467,8,19,.421,18,22,.818,9,29,38,13,0,8,16,20,70,False,543,Maryland
10,School Totals,200,28,60,.467,18,41,.439,10,19,.526,11,17,.647,4,27,31,16,4,3,6,15,77,False,544,Maryland
11,School Totals,199,20,56,.357,12,31,.387,8,25,.320,11,15,.733,7,22,29,8,4,6,12,17,59,False,545,Maryland
13,School Totals,200,17,51,.333,14,33,.424,3,18,.167,24,34,.706,11,21,32,9,10,1,15,25,61,False,546,Maryland
10,School Totals,200,25,63,.397,18,37,.486,7,26,.269,17,23,.739,18,19,37,13,9,3,11,19,74,False,547,Maryland
11,School Totals,199,22,70,.314,15,48,.313,7,22,.318,5,13,.385,19,25,44,9,4,5,12,23,56,False,548,Maryland
11,School Totals,200,26,54,.481,22,37,.595,4,17,.235,23,30,.767,4,21,25,13,9,3,17,29,79,False,549,Maryland
11,School Totals,200,28,50,.560,18,29,.621,10,21,.476,8,13,.615,4,19,23,15,7,1,10,19,74,False,550,Maryland
16,School Totals,200,29,56,.518,21,41,.512,8,15,.533,14,24,.583,12,22,34,15,4,3,9,19,80,False,551,Maryland
10,School Totals,200,22,56,.393,16,33,.485,6,23,.261,13,20,.650,8,22,30,11,5,7,16,29,63,False,552,Maryland
10,School Totals,200,27,52,.519,17,28,.607,10,24,.417,19,23,.826,8,21,29,12,9,5,12,20,83,False,553,Maryland
10,School Totals,200,21,52,.404,15,31,.484,6,21,.286,5,8,.625,7,20,27,9,5,5,9,19,53,False,554,Maryland
11,School Totals,200,26,62,.419,23,48,.479,3,14,.214,12,19,.632,13,25,38,8,4,2,14,25,67,False,555,Maryland
11,School Totals,200,26,61,.426,18,35,.514,8,26,.308,11,16,.688,8,26,34,13,9,3,12,19,71,False,556,Maryland
10,School Totals,200,14,40,.350,6,18,.333,8,22,.364,19,27,.704,4,27,31,7,6,4,18,13,55,False,557,Maryland
11,School Totals,250,24,79,.304,15,47,.319,9,32,.281,16,21,.762,17,37,54,10,7,5,12,26,73,False,558,Maryland
16,School Totals,200,24,60,.400,14,28,.500,10,32,.313,6,7,.857,6,22,28,18,6,5,5,14,64,False,559,Maryland
11,School Totals,225,23,48,.479,18,31,.581,5,17,.294,24,30,.800,5,25,30,8,3,4,12,19,75,False,560,Maryland
11,School Totals,200,20,51,.392,12,28,.429,8,23,.348,17,22,.773,5,16,21,8,11,5,12,20,65,False,561,Maryland
13,School Totals,200,24,44,.545,17,30,.567,7,14,.500,27,41,.659,8,30,38,9,2,6,13,19,82,False,562,Maryland
14,School Totals,200,35,63,.556,25,40,.625,10,23,.435,13,18,.722,10,27,37,15,7,9,10,13,93,False,563,Maryland
11,School Totals,200,21,47,.447,13,24,.542,8,23,.348,16,27,.593,10,27,37,13,6,2,15,15,66,False,564,Maryland
10,School Totals,200,28,59,.475,22,46,.478,6,13,.462,16,18,.889,10,18,28,9,8,5,10,14,78,False,565,Maryland
10,School Totals,200,26,59,.441,18,40,.450,8,19,.421,12,15,.800,7,29,36,13,4,3,10,21,72,False,566,Maryland
11,School Totals,200,17,45,.378,11,26,.423,6,19,.316,21,26,.808,6,22,28,10,4,3,9,18,61,False,567,Maryland
11,School Totals,200,37,64,.578,34,52,.654,3,12,.250,18,26,.692,10,29,39,15,6,10,20,15,95,False,568,Maryland
10,School Totals,200,16,40,.400,10,22,.455,6,18,.333,27,36,.750,3,18,21,6,2,2,7,19,65,False,569,Maryland
10,School Totals,200,22,46,.478,13,24,.542,9,22,.409,29,35,.829,6,27,33,15,4,7,10,18,82,False,570,Maryland
11,School Totals,200,21,43,.488,14,28,.500,7,15,.467,18,27,.667,6,27,33,13,2,3,14,11,67,False,571,Maryland
10,School Totals,200,22,55,.400,16,30,.533,6,25,.240,17,23,.739,14,26,40,10,4,3,12,13,67,False,572,Maryland
11,School Totals,200,24,53,.453,14,27,.519,10,26,.385,15,18,.833,6,29,35,13,9,1,13,16,73,False,573,Maryland
12,School Totals,200,25,50,.500,17,30,.567,8,20,.400,14,16,.875,3,29,32,14,6,4,9,13,72,False,574,Maryland
11,School Totals,250,19,57,.333,15,35,.429,4,22,.182,26,32,.813,10,36,46,8,7,4,20,24,68,False,575,Maryland
11,School Totals,200,21,50,.420,13,24,.542,8,26,.308,20,28,.714,11,32,43,13,7,9,19,16,70,False,576,Maryland
11,School Totals,200,19,52,.365,10,31,.323,9,21,.429,10,18,.556,7,25,32,11,2,4,10,19,57,False,577,Maryland
11,School Totals,200,18,48,.375,12,28,.429,6,20,.300,27,31,.871,8,20,28,8,10,5,10,22,69,False,578,Maryland
11,School Totals,200,21,61,.344,10,33,.303,11,28,.393,20,28,.714,15,29,44,14,5,4,12,11,73,False,579,Maryland
13,School Totals,200,22,51,.431,11,30,.367,11,21,.524,20,22,.909,7,22,29,11,2,6,8,17,75,False,580,Maryland
12,School Totals,200,27,53,.509,17,33,.515,10,20,.500,6,12,.500,5,16,21,11,7,3,11,16,70,False,185,Maryland
11,School Totals,200,22,54,.407,16,40,.400,6,14,.429,18,25,.720,10,15,25,11,9,0,10,14,68,False,581,Maryland
12,School Totals,200,18,59,.305,9,33,.273,9,26,.346,11,16,.688,9,21,30,9,3,1,9,21,56,False,582,Maryland
10,School Totals,200,23,52,.442,20,37,.541,3,15,.200,15,24,.625,8,29,37,9,5,4,15,12,64,False,583,Maryland
12,School Totals,200,18,49,.367,11,26,.423,7,23,.304,12,16,.750,7,9,16,10,9,5,16,19,55,False,584,Maryland
10,School Totals,200,24,49,.490,14,28,.500,10,21,.476,10,14,.714,6,27,33,9,0,8,13,13,68,False,191,Maryland
12,School Totals,200,23,47,.489,14,28,.500,9,19,.474,21,26,.808,2,26,28,10,2,4,11,18,76,False,585,Maryland
11,School Totals,200,20,43,.465,13,24,.542,7,19,.368,22,25,.880,1,21,22,9,4,4,10,12,69,False,586,Maryland
11,School Totals,200,24,50,.480,22,43,.512,2,7,.286,9,11,.818,6,24,30,8,5,5,6,14,59,False,587,Maryland
14,School Totals,200,21,47,.447,10,25,.400,11,22,.500,13,15,.867,8,24,32,14,3,1,12,12,66,False,588,Maryland
11,School Totals,200,22,57,.386,17,35,.486,5,22,.227,11,13,.846,13,22,35,6,8,3,8,18,60,False,589,Maryland
12,School Totals,200,19,47,.404,14,29,.483,5,18,.278,21,25,.840,8,30,38,10,0,5,17,26,64,False,590,Maryland
10,School Totals,200,22,49,.449,16,35,.457,6,14,.429,25,33,.758,10,22,32,12,4,3,11,18,75,False,199,Maryland
11,School Totals,200,20,50,.400,12,30,.400,8,20,.400,10,13,.769,7,17,24,12,4,3,12,18,58,False,591,Maryland
12,School Totals,200,19,40,.475,10,19,.526,9,21,.429,18,24,.750,3,27,30,9,5,5,11,19,65,False,592,Maryland
12,School Totals,200,21,44,.477,13,25,.520,8,19,.421,9,13,.692,8,22,30,7,4,7,21,19,59,False,593,Maryland
11,School Totals,200,33,56,.589,26,38,.684,7,18,.389,7,9,.778,7,37,44,15,5,3,14,13,80,False,594,Maryland
10,School Totals,200,22,48,.458,14,27,.519,8,21,.381,23,32,.719,6,20,26,13,8,2,9,15,75,False,595,Maryland
11,School Totals,200,23,50,.460,18,28,.643,5,22,.227,14,22,.636,12,19,31,8,4,4,11,16,65,False,596,Maryland
10,School Totals,200,28,56,.500,23,34,.676,5,22,.227,16,21,.762,6,21,27,12,11,9,12,18,77,False,597,Maryland
13,School Totals,200,30,50,.600,20,33,.606,10,17,.588,16,23,.696,4,27,31,15,8,9,18,26,86,False,598,Maryland
13,School Totals,200,29,50,.580,22,36,.611,7,14,.500,15,18,.833,9,16,25,22,5,2,10,10,80,False,599,Maryland
11,School Totals,200,30,59,.508,18,33,.545,12,26,.462,9,11,.818,7,21,28,16,8,6,21,21,81,False,600,Maryland
15,School Totals,200,31,46,.674,22,27,.815,9,19,.474,25,29,.862,4,27,31,22,7,7,10,18,96,False,601,Maryland
12,School Totals,200,25,54,.463,22,40,.550,3,14,.214,23,29,.793,10,29,39,8,4,1,15,14,76,False,602,Maryland
14,School Totals,200,23,45,.511,13,24,.542,10,21,.476,21,24,.875,4,19,23,16,4,5,10,12,77,False,603,Maryland
15,School Totals,200,32,57,.561,20,32,.625,12,25,.480,6,9,.667,9,28,37,20,8,7,13,15,82,False,604,Maryland
15,School Totals,200,34,66,.515,21,39,.538,13,27,.481,6,8,.750,9,34,43,16,4,4,18,12,87,False,605,Maryland
10,School Totals,200,19,57,.333,14,36,.389,5,21,.238,27,38,.711,15,20,35,10,5,4,9,17,70,False,606,Maryland
12,School Totals,200,27,58,.466,16,27,.593,11,31,.355,7,12,.583,6,28,34,21,9,9,11,20,72,False,607,Maryland
15,School Totals,200,30,65,.462,22,40,.550,8,25,.320,20,25,.800,14,31,45,10,5,6,12,15,88,False,608,Maryland
9,School Totals,200,25,48,.521,21,37,.568,4,11,.364,9,12,.750,5,28,33,10,3,6,16,15,63,False,609,Maryland
11,School Totals,200,26,58,.448,20,34,.588,6,24,.250,9,11,.818,10,24,34,8,3,2,12,16,67,False,610,Maryland
15,School Totals,200,37,59,.627,26,38,.684,11,21,.524,15,21,.714,6,26,32,23,7,5,14,20,100,False,611,Maryland
9,School Totals,225,21,48,.438,17,31,.548,4,17,.235,16,19,.842,3,26,29,10,6,8,15,14,62,False,612,Maryland
10,School Totals,200,22,57,.386,14,30,.467,8,27,.296,13,16,.813,6,26,32,11,3,6,9,22,65,False,613,Maryland
10,School Totals,200,26,58,.448,20,33,.606,6,25,.240,16,23,.696,9,25,34,16,7,6,9,18,74,False,614,Maryland
10,School Totals,200,21,50,.420,17,34,.500,4,16,.250,20,23,.870,9,31,40,12,3,4,13,20,66,False,615,Maryland
11,School Totals,200,25,49,.510,18,33,.545,7,16,.438,13,22,.591,11,29,40,14,4,13,16,18,70,False,616,Maryland
11,School Totals,200,22,54,.407,18,36,.500,4,18,.222,24,27,.889,4,32,36,11,5,2,8,11,72,False,617,Maryland
15,School Totals,200,28,47,.596,24,34,.706,4,13,.308,33,44,.750,9,26,35,15,8,6,14,16,93,False,618,Maryland
11,School Totals,200,20,50,.400,15,36,.417,5,14,.357,12,22,.545,7,20,27,11,8,9,12,19,57,False,619,Maryland
10,School Totals,200,21,56,.375,14,37,.378,7,19,.368,14,19,.737,6,30,36,10,5,9,15,21,63,False,620,Maryland
9,School Totals,200,31,57,.544,24,41,.585,7,16,.438,17,19,.895,8,24,32,11,7,7,18,12,86,False,621,Maryland
10,School Totals,200,28,61,.459,21,41,.512,7,20,.350,16,18,.889,7,13,20,13,10,7,6,21,79,False,622,Maryland
15,School Totals,200,30,54,.556,16,29,.552,14,25,.560,7,10,.700,8,27,35,21,3,5,14,13,81,False,623,Maryland
9,School Totals,200,24,58,.414,16,34,.471,8,24,.333,6,8,.750,11,19,30,12,4,1,12,18,62,False,231,Maryland
11,School Totals,200,35,58,.603,22,36,.611,13,22,.591,14,22,.636,5,23,28,20,4,2,12,17,97,False,624,Maryland
9,School Totals,200,18,54,.333,10,32,.313,8,22,.364,17,21,.810,10,18,28,9,8,1,4,14,61,False,625,Maryland
10,School Totals,200,23,45,.511,14,22,.636,9,23,.391,24,27,.889,4,22,26,10,5,3,13,17,79,False,626,Maryland
9,School Totals,200,22,48,.458,21,30,.700,1,18,.056,28,31,.903,2,33,35,8,5,7,10,18,73,False,627,Maryland
10,School Totals,200,22,55,.400,17,30,.567,5,25,.200,14,20,.700,5,21,26,9,7,7,9,23,63,False,628,Maryland
11,School Totals,200,20,52,.385,16,38,.421,4,14,.286,18,25,.720,16,25,41,7,3,2,17,10,62,False,629,Maryland
11,School Totals,200,26,58,.448,19,31,.613,7,27,.259,17,22,.773,8,25,33,11,6,7,14,32,76,False,630,Maryland
13,School Totals,200,27,62,.435,20,35,.571,7,27,.259,32,48,.667,21,26,47,18,12,7,12,18,93,False,631,Maryland
10,School Totals,200,18,51,.353,9,25,.360,9,26,.346,26,32,.813,6,23,29,10,3,8,12,23,71,False,632,Maryland
13,School Totals,200,23,47,.489,15,28,.536,8,19,.421,23,33,.697,3,29,32,12,5,4,11,24,77,False,633,Maryland
11,School Totals,225,27,67,.403,17,36,.472,10,31,.323,24,34,.706,14,26,40,11,7,3,17,20,88,False,634,Maryland
12,School Totals,200,25,55,.455,20,38,.526,5,17,.294,14,19,.737,12,18,30,14,3,9,8,15,69,False,635,Maryland
12,School Totals,200,21,61,.344,11,25,.440,10,36,.278,7,12,.583,9,25,34,12,2,6,14,19,59,False,636,Maryland
11,School Totals,200,24,59,.407,20,37,.541,4,22,.182,19,29,.655,15,23,38,11,4,5,18,18,71,False,637,Maryland
13,School Totals,200,29,58,.500,17,28,.607,12,30,.400,9,11,.818,10,26,36,20,4,6,13,16,79,False,638,Maryland
11,School Totals,200,20,44,.455,13,26,.500,7,18,.389,19,29,.655,3,28,31,13,4,3,11,14,66,False,639,Maryland
13,School Totals,200,27,47,.574,16,30,.533,11,17,.647,27,35,.771,6,22,28,16,7,3,12,20,92,False,640,Maryland
12,School Totals,200,27,55,.491,16,30,.533,11,25,.440,23,29,.793,9,24,33,16,8,2,21,13,88,False,641,Maryland
10,School Totals,200,33,59,.559,26,38,.684,7,21,.333,11,18,.611,7,26,33,16,7,4,14,20,84,False,642,Maryland
11,School Totals,200,23,65,.354,12,40,.300,11,25,.440,8,16,.500,14,22,36,11,6,6,16,23,65,False,643,Maryland
10,School Totals,200,28,54,.519,18,39,.462,10,15,.667,11,14,.786,8,22,30,13,5,2,11,13,77,False,644,Maryland
10,School Totals,200,25,57,.439,18,38,.474,7,19,.368,18,22,.818,9,20,29,9,4,9,8,15,75,False,252,Maryland
10,School Totals,200,23,54,.426,17,32,.531,6,22,.273,10,20,.500,7,28,35,10,8,3,11,16,62,False,645,Maryland
10,School Totals,200,30,53,.566,19,30,.633,11,23,.478,13,18,.722,4,31,35,23,14,4,21,21,84,False,646,Maryland
12,School Totals,200,23,52,.442,15,32,.469,8,20,.400,13,19,.684,9,25,34,15,7,6,18,19,67,False,647,Maryland
11,School Totals,200,30,59,.508,19,41,.463,11,18,.611,14,22,.636,8,22,30,19,5,2,7,18,85,False,648,Maryland
11,School Totals,200,27,55,.491,17,29,.586,10,26,.385,13,17,.765,11,19,30,15,1,5,11,16,77,False,649,Maryland
11,School Totals,200,23,58,.397,19,39,.487,4,19,.211,22,28,.786,7,27,34,14,4,10,11,20,72,False,650,Maryland
12,School Totals,200,20,59,.339,13,33,.394,7,26,.269,17,27,.630,11,22,33,13,7,2,11,24,64,False,651,Maryland
11,School Totals,200,27,55,.491,15,26,.577,12,29,.414,20,28,.714,7,20,27,19,3,3,7,18,86,False,652,Maryland
11,School Totals,200,27,54,.500,19,36,.528,8,18,.444,12,17,.706,5,28,33,15,6,4,13,19,74,False,653,Maryland
11,School Totals,200,19,45,.422,11,27,.407,8,18,.444,14,23,.609,3,22,25,13,4,6,13,25,60,False,654,Maryland
10,School Totals,200,30,73,.411,23,46,.500,7,27,.259,8,13,.615,11,23,34,22,2,0,10,18,75,False,655,Maryland
11,School Totals,200,26,58,.448,15,24,.625,11,34,.324,6,9,.667,9,22,31,18,6,6,14,15,69,False,656,Maryland
11,School Totals,200,31,57,.544,23,37,.622,8,20,.400,9,11,.818,11,20,31,18,6,7,10,17,79,False,657,Maryland
11,School Totals,200,22,52,.423,14,27,.519,8,25,.320,11,16,.688,7,24,31,11,2,4,7,14,63,False,658,Maryland
11,School Totals,200,24,51,.471,18,35,.514,6,16,.375,10,17,.588,8,16,24,14,8,3,12,21,64,False,659,Maryland
11,School Totals,200,22,54,.407,15,27,.556,7,27,.259,14,19,.737,6,14,20,13,7,3,11,19,65,False,660,Maryland
13,School Totals,200,27,55,.491,25,41,.610,2,14,.143,20,26,.769,7,34,41,12,4,3,14,17,76,False,661,Maryland
16,School Totals,200,33,54,.611,24,35,.686,9,19,.474,21,33,.636,14,28,42,15,6,7,12,12,96,False,662,Maryland
10,School Totals,200,27,47,.574,18,27,.667,9,20,.450,16,23,.696,6,32,38,14,6,7,20,17,79,False,663,Maryland
11,School Totals,200,28,59,.475,24,46,.522,4,13,.308,20,25,.800,9,26,35,12,3,5,16,12,80,False,664,Maryland
15,School Totals,200,26,52,.500,15,25,.600,11,27,.407,13,19,.684,14,26,40,16,3,7,15,7,76,False,665,Maryland
11,School Totals,200,19,45,.422,14,22,.636,5,23,.217,18,23,.783,8,22,30,11,5,6,20,19,61,False,666,Maryland
15,School Totals,200,24,46,.522,16,31,.516,8,15,.533,24,27,.889,7,29,36,15,3,6,22,18,80,False,667,Maryland
11,School Totals,200,23,51,.451,12,28,.429,11,23,.478,13,20,.650,9,18,27,22,7,5,18,21,70,False,668,Maryland
11,School Totals,200,22,63,.349,12,35,.343,10,28,.357,21,26,.808,14,19,33,12,6,1,7,19,75,False,669,Maryland
10,School Totals,225,35,59,.593,27,41,.659,8,18,.444,14,19,.737,8,26,34,15,6,5,25,19,92,False,670,Maryland
16,School Totals,200,32,66,.485,23,40,.575,9,26,.346,14,16,.875,11,34,45,16,7,8,19,19,87,False,671,Maryland
14,School Totals,200,30,55,.545,20,35,.571,10,20,.500,12,20,.600,8,25,33,21,5,6,10,15,82,False,672,Maryland
13,School Totals,200,26,51,.510,15,27,.556,11,24,.458,13,21,.619,11,24,35,18,7,6,15,16,76,False,673,Maryland
12,School Totals,200,24,50,.480,17,30,.567,7,20,.350,20,23,.870,9,38,47,15,1,6,17,15,75,False,674,Maryland
11,School Totals,200,21,55,.382,11,31,.355,10,24,.417,14,17,.824,8,35,43,11,5,4,15,12,66,False,675,Maryland
9,School Totals,200,24,53,.453,20,40,.500,4,13,.308,23,34,.676,7,26,33,13,2,1,5,12,75,False,676,Maryland
10,School Totals,200,20,53,.377,12,33,.364,8,20,.400,13,15,.867,8,18,26,12,2,0,12,17,61,False,677,Maryland
9,School Totals,200,34,60,.567,30,43,.698,4,17,.235,19,25,.760,9,21,30,19,2,1,9,14,91,False,678,Maryland
11,School Totals,200,22,60,.367,14,38,.368,8,22,.364,17,26,.654,13,21,34,12,7,4,7,12,69,False,679,Maryland
9,School Totals,200,25,52,.481,17,32,.531,8,20,.400,9,14,.643,3,28,31,8,3,4,12,17,67,False,680,Maryland
10,School Totals,200,25,45,.556,17,31,.548,8,14,.571,19,24,.792,3,28,31,18,6,7,13,15,77,False,681,Maryland
9,School Totals,200,23,56,.411,14,33,.424,9,23,.391,13,17,.765,8,25,33,14,5,3,17,18,68,False,289,Maryland
10,School Totals,200,24,56,.429,17,39,.436,7,17,.412,13,19,.684,7,19,26,12,1,4,8,22,68,False,682,Maryland
9,School Totals,200,24,53,.453,17,30,.567,7,23,.304,12,15,.800,8,22,30,18,1,2,14,21,67,False,683,Maryland
9,School Totals,200,23,47,.489,19,33,.576,4,14,.286,18,19,.947,6,19,25,10,2,6,9,14,68,False,684,Maryland
10,School Totals,200,25,46,.543,16,29,.552,9,17,.529,11,14,.786,4,19,23,14,6,2,14,17,70,False,685,Maryland
9,School Totals,200,27,51,.529,18,30,.600,9,21,.429,10,11,.909,6,23,29,16,6,7,12,12,73,False,686,Maryland
10,School Totals,200,28,58,.483,23,42,.548,5,16,.313,5,9,.556,6,23,29,15,4,3,8,18,66,False,687,Maryland
9,School Totals,200,23,46,.500,18,29,.621,5,17,.294,10,14,.714,4,24,28,13,8,2,12,13,61,False,688,Maryland
9,School Totals,200,24,47,.511,19,30,.633,5,17,.294,18,22,.818,6,21,27,14,6,4,12,17,71,False,689,Maryland
12,School Totals,200,21,55,.382,18,37,.486,3,18,.167,16,20,.800,9,21,30,10,3,1,11,14,61,False,690,Maryland
10,School Totals,200,22,50,.440,20,36,.556,2,14,.143,8,9,.889,8,17,25,9,0,4,12,21,54,False,691,Maryland
11,School Totals,196,25,62,.403,23,43,.535,2,19,.105,21,30,.700,15,26,41,13,9,7,12,14,73,False,692,Maryland
11,School Totals,200,25,59,.424,20,36,.556,5,23,.217,23,27,.852,9,27,36,12,8,4,10,18,78,False,693,Maryland
14,School Totals,200,31,66,.470,21,36,.583,10,30,.333,10,16,.625,13,29,42,24,8,3,12,13,82,False,694,Maryland
11,School Totals,200,33,64,.516,26,42,.619,7,22,.318,7,13,.538,14,23,37,16,5,4,11,16,80,False,695,Maryland
16,School Totals,200,38,61,.623,31,42,.738,7,19,.368,9,15,.600,12,26,38,23,7,5,18,19,92,False,696,Maryland
16,School Totals,200,35,61,.574,26,45,.578,9,16,.563,25,36,.694,12,38,50,15,10,7,19,16,104,False,697,Maryland
10,School Totals,200,27,50,.540,20,33,.606,7,17,.412,10,16,.625,8,22,30,12,0,2,13,16,71,False,698,Maryland
10,School Totals,200,22,45,.489,18,31,.581,4,14,.286,18,25,.720,8,27,35,9,2,1,17,14,66,False,699,Maryland
10,School Totals,200,20,57,.351,11,30,.367,9,27,.333,11,14,.786,13,21,34,10,7,5,16,15,60,False,700,Maryland
11,School Totals,200,21,47,.447,13,22,.591,8,25,.320,5,7,.714,4,23,27,10,6,13,15,13,55,False,701,Maryland
15,School Totals,200,33,68,.485,22,47,.468,11,21,.524,17,19,.895,10,27,37,19,4,8,8,10,94,False,702,Maryland
9,School Totals,200,27,58,.466,19,33,.576,8,25,.320,12,20,.600,7,23,30,13,3,8,10,20,74,False,703,Maryland
11,School Totals,200,25,53,.472,18,33,.545,7,20,.350,21,25,.840,10,29,39,15,3,6,12,13,78,False,704,Maryland
10,School Totals,200,28,60,.467,20,43,.465,8,17,.471,10,14,.714,12,23,35,11,4,4,13,17,74,False,705,Maryland
11,School Totals,200,28,58,.483,21,38,.553,7,20,.350,14,20,.700,4,33,37,15,6,3,11,18,77,False,706,Maryland
10,School Totals,200,26,48,.542,20,38,.526,6,10,.600,24,27,.889,7,32,39,13,3,4,11,18,82,False,707,Maryland
10,School Totals,200,26,63,.413,18,38,.474,8,25,.320,18,22,.818,15,23,38,13,2,3,9,15,78,False,316,Maryland
10,School Totals,200,16,47,.340,8,31,.258,8,16,.500,24,29,.828,8,25,33,7,3,5,10,12,64,False,708,Maryland
10,School Totals,200,25,43,.581,14,26,.538,11,17,.647,14,16,.875,4,28,32,14,8,2,18,15,75,False,709,Maryland
10,School Totals,200,21,61,.344,12,35,.343,9,26,.346,4,7,.571,14,24,38,17,2,4,12,14,55,False,710,Maryland
11,School Totals,200,20,45,.444,14,26,.538,6,19,.316,21,24,.875,6,24,30,11,4,2,21,17,67,False,711,Maryland
13,School Totals,200,25,54,.463,18,38,.474,7,16,.438,13,16,.813,7,32,39,15,3,3,11,14,70,False,712,Maryland
15,School Totals,200,25,56,.446,17,36,.472,8,20,.400,3,8,.375,9,26,35,8,2,5,12,18,61,False,713,Maryland
10,School Totals,200,22,58,.379,15,38,.395,7,20,.350,9,18,.500,12,41,53,10,2,5,10,19,60,False,714,Maryland
10,School Totals,200,26,52,.500,18,25,.720,8,27,.296,10,15,.667,5,29,34,17,3,8,11,13,70,False,715,Maryland
10,School Totals,200,20,55,.364,14,33,.424,6,22,.273,6,8,.750,10,27,37,11,1,2,16,12,52,False,716,Maryland
10,School Totals,200,22,53,.415,10,25,.400,12,28,.429,10,12,.833,8,23,31,16,7,5,13,22,66,False,717,Maryland
10,School Totals,200,23,47,.489,17,30,.567,6,17,.353,20,25,.800,9,27,36,12,3,5,15,11,72,False,718,Maryland
11,School Totals,200,23,56,.411,21,37,.568,2,19,.105,13,15,.867,10,22,32,7,4,2,16,16,61,False,719,Maryland
10,School Totals,200,25,58,.431,19,38,.500,6,20,.300,6,10,.600,11,19,30,8,1,6,9,17,62,False,720,Maryland
12,School Totals,200,26,62,.419,19,42,.452,7,20,.350,10,12,.833,11,25,36,14,5,6,9,14,69,False,721,Maryland
10,School Totals,201,18,50,.360,12,30,.400,6,20,.300,19,23,.826,5,24,29,13,4,5,11,16,61,False,722,Maryland
10,School Totals,200,30,69,.435,24,47,.511,6,22,.273,13,20,.650,14,25,39,12,3,4,5,18,79,False,723,Maryland
10,School Totals,200,21,63,.333,12,35,.343,9,28,.321,16,23,.696,13,28,41,12,6,7,11,13,67,False,724,Maryland
15,School Totals,200,37,76,.487,32,49,.653,5,27,.185,16,24,.667,17,28,45,15,8,8,8,6,95,False,725,Maryland
12,School Totals,200,25,56,.446,19,37,.514,6,19,.316,17,24,.708,10,31,41,14,7,5,16,21,73,False,726,Maryland
16,School Totals,200,30,57,.526,22,31,.710,8,26,.308,12,17,.706,8,31,39,19,10,6,13,17,80,False,727,Maryland
14,School Totals,200,26,59,.441,18,38,.474,8,21,.381,14,25,.560,12,26,38,13,6,6,8,13,74,False,728,Maryland
15,School Totals,200,25,62,.403,19,40,.475,6,22,.273,30,38,.789,14,27,41,12,2,4,10,19,86,False,729,Maryland
12,School Totals,200,24,56,.429,14,30,.467,10,26,.385,18,23,.783,10,22,32,12,4,6,14,20,76,False,730,Maryland
13,School Totals,200,24,60,.400,17,40,.425,7,20,.350,25,40,.625,15,29,44,9,6,3,15,15,80,False,731,Maryland
10,School Totals,200,31,65,.477,21,36,.583,10,29,.345,12,16,.750,12,28,40,13,6,4,10,13,84,False,732,Maryland
15,School Totals,200,27,67,.403,19,38,.500,8,29,.276,10,14,.714,10,35,45,18,4,10,7,11,72,False,733,Maryland
11,School Totals,200,21,63,.333,13,32,.406,8,31,.258,9,11,.818,12,26,38,12,6,4,11,17,59,False,734,Maryland
11,School Totals,200,19,57,.333,11,34,.324,8,23,.348,23,28,.821,14,30,44,9,4,3,20,16,69,False,735,Maryland
12,School Totals,200,14,52,.269,9,31,.290,5,21,.238,15,20,.750,9,29,38,8,5,5,16,18,48,False,736,Maryland
14,School Totals,200,26,55,.473,19,41,.463,7,14,.500,25,32,.781,14,28,42,14,3,4,16,9,84,False,737,Maryland
13,School Totals,200,24,62,.387,18,38,.474,6,24,.250,21,25,.840,9,25,34,10,5,3,7,16,75,False,349,Maryland
11,School Totals,200,21,46,.457,13,28,.464,8,18,.444,17,24,.708,5,27,32,13,3,5,16,16,67,False,738,Maryland
13,School Totals,200,17,52,.327,13,30,.433,4,22,.182,11,20,.550,9,22,31,11,8,5,17,14,49,False,739,Maryland
10,School Totals,200,19,47,.404,12,25,.480,7,22,.318,9,13,.692,10,25,35,7,2,0,14,14,54,False,740,Maryland
10,School Totals,200,21,51,.412,14,27,.519,7,24,.292,8,11,.727,11,21,32,14,2,7,12,12,57,False,741,Maryland
10,School Totals,200,19,54,.352,6,21,.286,13,33,.394,26,29,.897,7,18,25,16,7,2,6,15,77,False,742,Maryland
10,School Totals,200,27,56,.482,15,27,.556,12,29,.414,11,18,.611,9,19,28,14,3,3,5,15,77,False,355,Maryland
10,School Totals,200,26,57,.456,19,32,.594,7,25,.280,23,26,.885,10,31,41,14,1,8,10,18,82,False,743,Maryland
11,School Totals,200,18,53,.340,10,26,.385,8,27,.296,12,15,.800,6,35,41,11,2,7,11,10,56,False,744,Maryland
10,School Totals,200,26,56,.464,16,30,.533,10,26,.385,13,15,.867,4,25,29,16,6,2,10,16,75,False,745,Maryland
9,School Totals,200,25,52,.481,18,29,.621,7,23,.304,15,22,.682,5,27,32,20,4,2,17,14,72,False,746,Maryland
10,School Totals,200,23,56,.411,14,31,.452,9,25,.360,12,15,.800,6,27,33,15,6,2,9,14,67,False,747,Maryland
10,School Totals,200,25,61,.410,17,31,.548,8,30,.267,18,22,.818,12,29,41,17,3,2,5,8,76,False,748,Maryland
11,School Totals,200,23,51,.451,13,22,.591,10,29,.345,16,19,.842,6,19,25,12,3,3,10,24,72,False,749,Maryland
11,School Totals,200,25,66,.379,19,38,.500,6,28,.214,18,22,.818,18,24,42,14,8,5,7,18,74,False,750,Maryland
9,School Totals,200,23,54,.426,17,34,.500,6,20,.300,14,21,.667,8,20,28,11,2,2,9,12,66,False,751,Maryland
12,School Totals,200,25,65,.385,19,33,.576,6,32,.188,11,15,.733,10,25,35,13,1,4,8,17,67,False,752,Maryland
12,School Totals,200,28,50,.560,20,30,.667,8,20,.400,19,25,.760,6,22,28,13,5,4,8,15,83,False,753,Maryland
14,School Totals,200,30,63,.476,20,40,.500,10,23,.435,15,18,.833,10,31,41,13,3,3,9,17,85,False,754,Maryland
12,School Totals,200,30,44,.682,22,29,.759,8,15,.533,14,19,.737,2,27,29,21,7,3,15,14,82,False,755,Maryland
10,School Totals,200,31,52,.596,24,33,.727,7,19,.368,10,10,1.000,5,22,27,14,4,5,10,15,79,False,756,Maryland
13,School Totals,200,26,50,.520,17,27,.630,9,23,.391,29,45,.644,13,31,44,19,8,7,16,19,90,False,757,Maryland
12,School Totals,200,20,50,.400,14,32,.438,6,18,.333,5,11,.455,6,19,25,12,5,5,14,13,51,False,758,Maryland
10,School Totals,200,21,61,.344,17,41,.415,4,20,.200,14,18,.778,11,25,36,10,4,4,9,16,60,False,759,Maryland
10,School Totals,200,30,65,.462,23,37,.622,7,28,.250,17,24,.708,13,25,38,14,7,2,4,10,84,False,760,Maryland
11,School Totals,200,25,58,.431,15,30,.500,10,28,.357,10,21,.476,5,23,28,14,5,3,5,18,70,False,761,Maryland
11,School Totals,200,26,52,.500,20,35,.571,6,17,.353,12,15,.800,4,27,31,11,3,5,9,17,70,False,762,Maryland
12,School Totals,200,28,58,.483,15,36,.417,13,22,.591,4,6,.667,6,15,21,14,4,2,10,13,73,False,763,Maryland
10,School Totals,200,20,52,.385,13,27,.481,7,25,.280,8,15,.533,6,26,32,8,4,2,10,18,55,False,378,Maryland
13,School Totals,200,26,60,.433,14,25,.560,12,35,.343,3,6,.500,4,24,28,18,4,1,16,10,67,False,764,Maryland
10,School Totals,200,22,55,.400,14,35,.400,8,20,.400,14,17,.824,7,22,29,8,2,7,10,13,66,False,765,Maryland
15,School Totals,200,32,53,.604,20,27,.741,12,26,.462,24,34,.706,1,38,39,27,3,3,15,16,100,False,766,Maryland
14,School Totals,200,21,51,.412,17,32,.531,4,19,.211,17,30,.567,3,19,22,9,4,1,10,15,63,False,767,Maryland
10,School Totals,200,19,45,.422,11,22,.500,8,23,.348,17,29,.586,6,29,35,12,5,5,11,20,63,False,768,Maryland
9,School Totals,200,19,53,.358,10,23,.435,9,30,.300,8,9,.889,3,23,26,12,6,3,9,13,55,False,769,Maryland
10,School Totals,200,21,46,.457,12,21,.571,9,25,.360,10,15,.667,3,17,20,13,10,2,10,15,61,False,770,Maryland
10,School Totals,200,17,48,.354,14,31,.452,3,17,.176,13,16,.813,5,20,25,6,6,7,16,16,50,False,771,Maryland
10,School Totals,200,22,55,.400,17,36,.472,5,19,.263,16,18,.889,5,26,31,11,5,2,12,14,65,False,772,Maryland
10,School Totals,200,27,51,.529,17,31,.548,10,20,.500,8,11,.727,6,28,34,16,1,3,10,16,72,False,773,Maryland
12,School Totals,200,23,53,.434,14,24,.583,9,29,.310,9,10,.900,6,36,42,9,5,3,17,13,64,False,774,Maryland
13,School Totals,200,29,61,.475,16,28,.571,13,33,.394,8,12,.667,7,23,30,18,8,4,4,9,79,False,775,Maryland
9,School Totals,200,22,47,.468,16,27,.593,6,20,.300,18,28,.643,6,24,30,12,9,1,11,14,68,False,776,Maryland
9,School Totals,200,21,43,.488,13,27,.481,8,16,.500,23,24,.958,2,28,30,13,3,4,7,16,73,False,777,Maryland
9,School Totals,200,21,50,.420,12,24,.500,9,26,.346,4,7,.571,4,26,30,13,6,3,15,13,55,False,778,Maryland
9,School Totals,200,23,48,.479,15,27,.556,8,21,.381,7,13,.538,1,29,30,12,5,4,13,19,61,False,779,Maryland
12,School Totals,200,21,55,.382,15,35,.429,6,20,.300,20,28,.714,10,25,35,10,8,2,11,19,68,False,780,Maryland
9,School Totals,200,26,54,.481,18,28,.643,8,26,.308,6,8,.750,4,18,22,16,1,2,9,10,66,False,781,Maryland
9,School Totals,200,22,43,.512,13,25,.520,9,18,.500,10,14,.714,3,24,27,13,4,4,10,14,63,False,782,Maryland
13,School Totals,200,32,60,.533,22,33,.667,10,27,.370,3,7,.429,4,15,19,17,6,1,8,10,77,False,783,Maryland
15,School Totals,200,35,61,.574,26,36,.722,9,25,.360,18,22,.818,12,34,46,24,6,3,10,12,97,False,784,Michigan
12,School Totals,200,26,71,.366,16,43,.372,10,28,.357,15,22,.682,11,26,37,16,9,2,7,13,77,False,785,Michigan
10,School Totals,225,30,69,.435,20,42,.476,10,27,.370,13,23,.565,15,22,37,16,10,3,11,13,83,False,786,Michigan
11,School Totals,200,25,55,.455,22,35,.629,3,20,.150,12,18,.667,10,16,26,14,5,2,9,17,65,False,787,Michigan
10,School Totals,200,22,57,.386,16,32,.500,6,25,.240,16,20,.800,8,18,26,16,15,2,12,14,66,False,788,Michigan
11,School Totals,200,21,65,.323,12,31,.387,9,34,.265,7,11,.636,12,14,26,10,8,3,5,19,58,False,789,Michigan
11,School Totals,200,24,56,.429,18,32,.563,6,24,.250,13,16,.813,7,22,29,14,6,5,12,13,67,False,790,Michigan
12,School Totals,200,17,50,.340,10,28,.357,7,22,.318,11,20,.550,8,13,21,12,11,1,11,15,52,False,791,Michigan
11,School Totals,200,25,49,.510,17,25,.680,8,24,.333,17,21,.810,11,21,32,16,4,5,12,11,75,False,792,Michigan
10,School Totals,200,24,67,.358,19,39,.487,5,28,.179,11,13,.846,11,18,29,15,10,1,10,20,64,False,793,Michigan
13,School Totals,200,30,61,.492,19,28,.679,11,33,.333,5,8,.625,6,25,31,25,6,3,8,10,76,False,794,Michigan
10,School Totals,200,22,56,.393,13,28,.464,9,28,.321,12,15,.800,8,20,28,15,3,4,12,23,65,False,12,Michigan
10,School Totals,200,29,52,.558,23,36,.639,6,16,.375,9,15,.600,7,22,29,14,7,2,9,12,73,False,795,Michigan
9,School Totals,200,26,50,.520,19,26,.731,7,24,.292,5,8,.625,6,16,22,14,8,1,12,13,64,False,796,Michigan
10,School Totals,200,21,50,.420,14,27,.519,7,23,.304,13,14,.929,8,22,30,18,5,3,17,17,62,False,797,Michigan
11,School Totals,200,24,52,.462,20,34,.588,4,18,.222,17,19,.895,10,22,32,13,11,4,15,15,69,False,15,Michigan
10,School Totals,200,22,59,.373,13,31,.419,9,28,.321,15,20,.750,13,19,32,14,10,2,13,19,68,False,798,Michigan
10,School Totals,200,17,47,.362,11,28,.393,6,19,.316,8,11,.727,5,28,33,9,4,2,12,18,48,False,799,Michigan
11,School Totals,200,23,50,.460,16,33,.485,7,17,.412,6,11,.545,5,19,24,16,2,0,15,17,59,False,800,Michigan
10,School Totals,200,19,58,.328,12,29,.414,7,29,.241,11,14,.786,6,16,22,14,9,2,4,10,56,False,801,Michigan
10,School Totals,200,21,58,.362,14,32,.438,7,26,.269,11,14,.786,15,24,39,13,2,2,12,8,60,False,802,Michigan
12,School Totals,200,17,52,.327,9,24,.375,8,28,.286,10,14,.714,7,16,23,9,5,3,9,14,52,False,803,Michigan
12,School Totals,200,17,39,.436,15,28,.536,2,11,.182,8,14,.571,3,13,16,9,3,0,7,11,44,False,804,Michigan
10,School Totals,200,26,52,.500,19,38,.500,7,14,.500,12,19,.632,7,16,23,20,11,0,8,21,71,False,805,Michigan
9,School Totals,225,27,62,.435,13,35,.371,14,27,.519,12,16,.750,13,21,34,17,5,4,9,18,80,False,806,Michigan
9,School Totals,200,19,53,.358,13,25,.520,6,28,.214,7,11,.636,6,14,20,10,5,3,6,14,51,False,807,Michigan
9,School Totals,200,16,65,.246,10,34,.294,6,31,.194,6,12,.500,12,22,34,10,9,1,5,14,44,False,808,Michigan
10,School Totals,200,17,47,.362,12,30,.400,5,17,.294,16,20,.800,4,16,20,7,5,0,6,16,55,False,809,Michigan
11,School Totals,200,32,53,.604,24,34,.706,8,19,.421,11,16,.688,7,14,21,21,5,1,4,10,83,False,810,Michigan
11,School Totals,200,15,43,.349,11,22,.500,4,21,.190,14,20,.700,7,16,23,9,13,2,19,13,48,False,811,Michigan
9,School Totals,200,19,50,.380,13,25,.520,6,25,.240,15,18,.833,9,19,28,13,6,1,8,14,59,False,812,Michigan
9,School Totals,200,24,49,.490,16,28,.571,8,21,.381,12,14,.857,8,15,23,13,5,1,11,14,68,False,813,Michigan
15,School Totals,200,22,50,.440,15,28,.536,7,22,.318,15,21,.714,10,29,39,12,6,3,12,14,66,False,814,Michigan
15,School Totals,200,26,54,.481,18,37,.486,8,17,.471,9,14,.643,10,30,40,20,5,2,13,19,69,False,815,Michigan
15,School Totals,200,33,63,.524,25,41,.610,8,22,.364,6,8,.750,13,27,40,19,5,1,14,12,80,False,816,Michigan
11,School Totals,200,20,62,.323,12,30,.400,8,32,.250,2,4,.500,11,23,34,11,6,1,7,19,50,False,817,Michigan
12,School Totals,200,16,53,.302,11,24,.458,5,29,.172,19,26,.731,9,21,30,5,5,2,12,15,56,False,818,Michigan
11,School Totals,200,22,49,.449,16,29,.552,6,20,.300,19,28,.679,8,26,34,13,6,1,13,18,69,False,819,Michigan
10,School Totals,200,25,53,.472,15,27,.556,10,26,.385,5,10,.500,11,21,32,11,2,1,14,12,65,False,820,Michigan
13,School Totals,200,35,72,.486,28,49,.571,7,23,.304,9,16,.563,15,30,45,18,6,1,8,10,86,False,821,Michigan
12,School Totals,200,27,59,.458,19,37,.514,8,22,.364,13,16,.813,6,24,30,17,8,4,8,18,75,False,822,Michigan
13,School Totals,200,23,56,.411,15,27,.556,8,29,.276,10,14,.714,14,22,36,14,1,1,5,17,64,False,823,Michigan
10,School Totals,200,25,56,.446,19,37,.514,6,19,.316,13,16,.813,7,31,38,17,4,5,12,16,69,False,824,Michigan
13,School Totals,200,28,58,.483,12,26,.462,16,32,.500,15,22,.682,8,22,30,21,2,2,3,8,87,False,825,Michigan
12,School Totals,200,21,55,.382,12,32,.375,9,23,.391,6,8,.750,6,20,26,12,2,7,14,19,57,False,826,Michigan
9,School Totals,200,27,47,.574,19,27,.704,8,20,.400,14,14,1.000,3,20,23,17,2,2,10,17,76,False,827,Michigan
13,School Totals,200,17,43,.395,9,22,.409,8,21,.381,8,8,1.000,2,18,20,11,3,0,10,18,50,False,828,Michigan
10,School Totals,225,21,63,.333,17,35,.486,4,28,.143,14,17,.824,12,29,41,9,7,2,14,21,60,False,829,Michigan
10,School Totals,200,24,46,.522,13,22,.591,11,24,.458,5,7,.714,4,17,21,12,4,2,12,18,64,False,830,Michigan
13,School Totals,200,20,55,.364,13,31,.419,7,24,.292,14,20,.700,7,10,17,9,9,0,6,22,61,False,48,Michigan
13,School Totals,200,23,58,.397,17,37,.459,6,21,.286,8,15,.533,11,20,31,8,1,1,7,17,60,False,831,Michigan
11,School Totals,200,23,53,.434,11,18,.611,12,35,.343,6,9,.667,3,8,11,15,6,3,7,21,64,False,832,Michigan
11,School Totals,200,23,46,.500,13,25,.520,10,21,.476,5,12,.417,5,23,28,13,6,1,12,14,61,False,833,Michigan
10,School Totals,200,33,56,.589,19,28,.679,14,28,.500,7,8,.875,7,21,28,22,4,2,10,16,87,False,834,Michigan
9,School Totals,200,23,55,.418,17,36,.472,6,19,.316,1,4,.250,5,21,26,10,4,0,13,23,53,False,835,Michigan
10,School Totals,200,25,51,.490,16,32,.500,9,19,.474,6,9,.667,6,21,27,10,2,2,5,18,65,False,836,Michigan
9,School Totals,200,27,52,.519,21,37,.568,6,15,.400,15,21,.714,9,23,32,16,6,5,13,13,75,False,837,Michigan
10,School Totals,200,23,43,.535,15,28,.536,8,15,.533,19,37,.514,1,24,25,13,7,3,12,23,73,False,56,Michigan
10,School Totals,200,22,59,.373,20,41,.488,2,18,.111,6,10,.600,7,24,31,15,5,0,4,11,52,False,838,Michigan
12,School Totals,225,25,52,.481,19,32,.594,6,20,.300,19,24,.792,7,20,27,14,9,1,13,22,75,False,839,Michigan
10,School Totals,200,20,41,.488,13,28,.464,7,13,.538,5,11,.455,2,24,26,12,2,1,10,12,52,False,840,Michigan
11,School Totals,200,25,55,.455,13,27,.481,12,28,.429,8,9,.889,6,20,26,15,6,4,4,11,70,False,841,Michigan
10,School Totals,200,21,50,.420,16,31,.516,5,19,.263,23,31,.742,4,21,25,13,4,3,6,18,70,False,842,Michigan
9,School Totals,200,20,48,.417,9,24,.375,11,24,.458,9,11,.818,6,19,25,13,7,2,10,15,60,False,843,Michigan
9,School Totals,200,22,59,.373,13,30,.433,9,29,.310,8,10,.800,7,20,27,10,4,2,9,20,61,False,844,Michigan
14,School Totals,200,33,64,.516,24,38,.632,9,26,.346,0,1,.000,11,24,35,20,5,2,10,17,75,False,845,Michigan
10,School Totals,200,27,53,.509,20,32,.625,7,21,.333,10,11,.909,4,14,18,13,7,0,7,23,71,False,846,Michigan
14,School Totals,200,22,56,.393,13,28,.464,9,28,.321,6,10,.600,6,29,35,12,7,5,10,10,59,False,847,Michigan
15,School Totals,200,25,54,.463,19,29,.655,6,25,.240,8,16,.500,12,18,30,13,8,2,14,15,64,False,848,Michigan
9,School Totals,200,19,42,.452,12,22,.545,7,20,.350,14,22,.636,8,12,20,13,4,1,10,16,59,False,849,Michigan
12,School Totals,200,27,50,.540,21,30,.700,6,20,.300,13,18,.722,5,31,36,15,2,6,13,20,73,False,850,Michigan
11,School Totals,200,31,63,.492,24,42,.571,7,21,.333,6,9,.667,11,18,29,10,4,3,9,19,75,False,851,Michigan
15,School Totals,200,29,47,.617,22,33,.667,7,14,.500,14,20,.700,9,22,31,14,6,4,14,15,79,False,852,Michigan
13,School Totals,200,22,50,.440,12,28,.429,10,22,.455,4,7,.571,2,22,24,8,5,3,11,20,58,False,853,Michigan
11,School Totals,200,27,56,.482,20,27,.741,7,29,.241,15,18,.833,6,28,34,14,2,1,11,15,76,False,854,Michigan
11,School Totals,200,31,54,.574,16,26,.615,15,28,.536,13,22,.591,8,27,35,21,3,2,17,24,90,False,855,Michigan
14,School Totals,200,22,50,.440,9,24,.375,13,26,.500,6,8,.750,7,25,32,17,7,3,19,9,63,False,856,Michigan
14,School Totals,200,30,55,.545,20,33,.606,10,22,.455,17,21,.810,10,29,39,19,7,4,15,15,87,False,857,Michigan
10,School Totals,200,31,68,.456,21,37,.568,10,31,.323,5,8,.625,10,24,34,25,3,1,6,13,77,False,858,Michigan
9,School Totals,200,25,53,.472,17,28,.607,8,25,.320,13,15,.867,8,24,32,15,7,3,8,13,71,False,859,Michigan
10,School Totals,200,20,52,.385,14,32,.438,6,20,.300,15,23,.652,14,20,34,9,2,1,10,12,61,False,860,Michigan
9,School Totals,200,27,58,.466,17,34,.500,10,24,.417,7,11,.636,7,21,28,13,8,1,12,17,71,False,77,Michigan
13,School Totals,200,19,48,.396,15,33,.455,4,15,.267,17,20,.850,12,22,34,6,7,0,9,9,59,False,861,Michigan
9,School Totals,225,22,66,.333,15,36,.417,7,30,.233,15,16,.938,14,19,33,10,6,3,7,15,66,False,862,Michigan
13,School Totals,200,20,52,.385,12,21,.571,8,31,.258,11,17,.647,8,20,28,9,2,0,10,22,59,False,863,Michigan
9,School Totals,200,23,45,.511,17,24,.708,6,21,.286,8,13,.615,1,14,15,8,8,5,8,8,60,False,864,Michigan
9,School Totals,200,25,61,.410,17,33,.515,8,28,.286,6,7,.857,11,22,33,15,2,1,10,18,64,False,865,Michigan
10,School Totals,200,27,50,.540,21,36,.583,6,14,.429,6,9,.667,7,23,30,15,2,1,12,13,66,False,866,Michigan
10,School Totals,200,19,53,.358,11,28,.393,8,25,.320,3,4,.750,6,16,22,10,5,1,13,16,49,False,867,Michigan
10,School Totals,200,22,46,.478,13,24,.542,9,22,.409,15,19,.789,3,19,22,13,5,2,5,16,68,False,85,Michigan
12,School Totals,200,19,48,.396,12,26,.462,7,22,.318,9,12,.750,3,12,15,15,6,0,10,16,54,False,868,Michigan
12,School Totals,200,24,46,.522,13,22,.591,11,24,.458,3,4,.750,2,18,20,16,6,0,4,12,62,False,869,Michigan
9,School Totals,200,23,46,.500,16,30,.533,7,16,.438,17,22,.773,4,21,25,13,10,0,9,20,70,False,870,Michigan
10,School Totals,200,22,47,.468,19,34,.559,3,13,.231,9,14,.643,4,20,24,8,3,0,8,15,56,False,871,Michigan
10,School Totals,225,21,56,.375,7,18,.389,14,38,.368,11,18,.611,9,21,30,15,4,6,6,17,67,False,872,Michigan
13,School Totals,200,25,60,.417,16,28,.571,9,32,.281,2,4,.500,8,19,27,12,1,1,9,15,61,False,873,Michigan
13,School Totals,200,21,45,.467,12,26,.462,9,19,.474,21,23,.913,5,26,31,11,6,2,12,19,72,False,874,Michigan
9,School Totals,200,25,42,.595,15,24,.625,10,18,.556,11,15,.733,4,19,23,10,5,5,13,19,71,False,875,Michigan
8,School Totals,225,24,49,.490,16,32,.500,8,17,.471,17,25,.680,7,15,22,9,7,3,9,16,73,False,876,Michigan
13,School Totals,200,17,55,.309,13,30,.433,4,25,.160,17,22,.773,14,21,35,7,6,2,18,14,55,False,877,Michigan
9,School Totals,200,22,54,.407,15,31,.484,7,23,.304,9,11,.818,8,17,25,11,2,0,10,16,60,False,878,Michigan
15,School Totals,200,38,66,.576,26,47,.553,12,19,.632,12,19,.632,11,28,39,19,5,3,9,12,100,False,879,Michigan
15,School Totals,200,33,55,.600,20,34,.588,13,21,.619,12,16,.750,6,33,39,18,3,1,13,10,91,False,880,Michigan
13,School Totals,200,30,59,.508,21,35,.600,9,24,.375,8,12,.667,11,34,45,16,3,1,10,9,77,False,881,Michigan
11,School Totals,200,23,50,.460,20,33,.606,3,17,.176,18,22,.818,8,23,31,8,5,2,9,15,67,False,882,Michigan
12,School Totals,200,29,56,.518,25,44,.568,4,12,.333,9,13,.692,8,32,40,12,2,5,9,17,71,False,883,Michigan
11,School Totals,200,27,54,.500,18,30,.600,9,24,.375,16,20,.800,6,16,22,14,3,4,6,9,79,False,884,Michigan
11,School Totals,200,26,53,.491,19,38,.500,7,15,.467,15,21,.714,12,20,32,16,6,2,13,16,74,False,885,Michigan
14,School Totals,200,29,58,.500,21,37,.568,8,21,.381,7,11,.636,7,26,33,18,7,1,10,16,73,False,886,Michigan
13,School Totals,200,29,62,.468,22,44,.500,7,18,.389,15,18,.833,16,23,39,14,5,6,12,8,80,False,887,Michigan
14,School Totals,200,27,61,.443,17,31,.548,10,30,.333,3,5,.600,10,25,35,18,7,1,7,4,67,False,888,Michigan
10,School Totals,200,28,50,.560,21,29,.724,7,21,.333,18,27,.667,7,18,25,13,8,3,14,18,81,False,889,Michigan
14,School Totals,200,35,69,.507,23,45,.511,12,24,.500,11,12,.917,16,27,43,26,10,3,11,7,93,False,890,Michigan
13,School Totals,200,35,68,.515,24,39,.615,11,29,.379,7,11,.636,8,20,28,21,4,2,3,10,88,False,891,Michigan
14,School Totals,200,34,57,.596,21,35,.600,13,22,.591,13,19,.684,8,29,37,17,8,2,12,14,94,False,892,Michigan
14,School Totals,200,36,62,.581,26,40,.650,10,22,.455,13,19,.684,8,29,37,24,3,4,6,13,95,False,893,Michigan
9,School Totals,200,21,54,.389,18,37,.486,3,17,.176,17,26,.654,11,31,42,6,3,1,4,7,62,False,894,Michigan
10,School Totals,200,18,47,.383,12,27,.444,6,20,.300,11,15,.733,4,21,25,8,4,5,13,13,53,False,895,Michigan
12,School Totals,200,28,51,.549,18,31,.581,10,20,.500,17,25,.680,6,13,19,19,13,4,11,19,83,False,896,Michigan
10,School Totals,200,27,55,.491,20,39,.513,7,16,.438,7,10,.700,9,23,32,11,6,5,10,9,68,False,897,Michigan
11,School Totals,200,31,59,.525,26,44,.591,5,15,.333,7,13,.538,10,23,33,13,9,2,12,12,74,False,898,Michigan
15,School Totals,200,25,49,.510,19,34,.559,6,15,.400,12,18,.667,6,23,29,14,3,3,2,9,68,False,899,Michigan
10,School Totals,200,30,70,.429,23,47,.489,7,23,.304,6,7,.857,9,13,22,13,5,3,8,19,73,False,120,Michigan
10,School Totals,225,28,60,.467,14,36,.389,14,24,.583,6,11,.545,11,16,27,18,7,4,11,9,76,False,900,Michigan
10,School Totals,225,28,71,.394,23,53,.434,5,18,.278,1,2,.500,9,28,37,12,8,1,6,13,62,False,901,Michigan
16,School Totals,200,21,53,.396,15,34,.441,6,19,.316,4,6,.667,6,22,28,6,5,1,16,16,52,False,902,Michigan
12,School Totals,200,23,49,.469,17,31,.548,6,18,.333,27,35,.771,7,16,23,12,4,2,6,15,79,False,903,Michigan
10,School Totals,200,25,49,.510,19,31,.613,6,18,.333,15,21,.714,6,22,28,15,9,1,10,11,71,False,904,Michigan
11,School Totals,200,30,58,.517,25,38,.658,5,20,.250,13,20,.650,14,23,37,13,6,1,15,21,78,False,905,Michigan
11,School Totals,200,25,59,.424,25,47,.532,0,12,.000,8,11,.727,9,19,28,10,11,1,7,17,58,False,906,Michigan
12,School Totals,200,25,59,.424,18,41,.439,7,18,.389,23,29,.793,6,19,25,15,9,0,5,18,80,False,907,Michigan
13,School Totals,200,27,65,.415,17,43,.395,10,22,.455,7,13,.538,10,16,26,10,5,7,6,16,71,False,129,Michigan
15,School Totals,200,29,63,.460,23,45,.511,6,18,.333,19,23,.826,13,21,34,15,6,9,3,10,83,False,908,Michigan
12,School Totals,200,23,57,.404,20,44,.455,3,13,.231,10,17,.588,6,27,33,7,6,4,11,18,59,False,909,Michigan
10,School Totals,200,28,55,.509,19,35,.543,9,20,.450,6,9,.667,7,19,26,12,6,3,9,8,71,False,910,Michigan
14,School Totals,200,31,60,.517,25,40,.625,6,20,.300,10,11,.909,10,26,36,17,7,0,12,7,78,False,911,Michigan
10,School Totals,225,35,71,.493,27,48,.563,8,23,.348,9,17,.529,11,24,35,18,7,1,9,12,87,False,912,Michigan
16,School Totals,200,30,65,.462,20,46,.435,10,19,.526,9,13,.692,8,26,34,18,13,5,9,13,79,False,913,Michigan
10,School Totals,201,21,53,.396,13,29,.448,8,24,.333,11,20,.550,13,23,36,17,5,3,10,11,61,False,914,Michigan
10,School Totals,200,25,48,.521,17,30,.567,8,18,.444,18,25,.720,8,18,26,12,3,2,12,15,76,False,915,Michigan
14,School Totals,200,20,53,.377,15,35,.429,5,18,.278,24,32,.750,12,25,37,13,10,2,7,11,69,False,916,Michigan
14,School Totals,200,31,61,.508,16,33,.485,15,28,.536,16,19,.842,8,33,41,19,6,5,9,15,93,False,917,Michigan
10,School Totals,200,29,69,.420,21,40,.525,8,29,.276,4,9,.444,8,24,32,14,8,0,12,20,70,False,918,Michigan
12,School Totals,200,31,58,.534,17,28,.607,14,30,.467,9,15,.600,4,25,29,18,5,2,10,14,85,False,919,Michigan
10,School Totals,225,28,65,.431,19,41,.463,9,24,.375,17,27,.630,13,24,37,19,6,3,7,14,82,False,920,Michigan
11,School Totals,200,19,61,.311,14,38,.368,5,23,.217,18,24,.750,14,26,40,8,12,2,13,17,61,False,921,Michigan
14,School Totals,200,32,62,.516,22,33,.667,10,29,.345,13,14,.929,16,27,43,19,2,6,7,17,87,False,922,Michigan
10,School Totals,200,25,56,.446,22,43,.512,3,13,.231,16,19,.842,7,22,29,12,1,0,11,17,69,False,923,Michigan
15,School Totals,200,36,56,.643,20,30,.667,16,26,.615,19,25,.760,6,22,28,26,8,4,7,9,107,False,924,Michigan
10,School Totals,200,24,48,.500,16,31,.516,8,17,.471,14,17,.824,5,16,21,9,3,6,11,17,70,False,925,Michigan
10,School Totals,200,21,52,.404,13,25,.520,8,27,.296,18,26,.692,7,20,27,16,6,1,8,22,68,False,926,Michigan
13,School Totals,200,33,59,.559,25,41,.610,8,18,.444,14,19,.737,8,27,35,16,5,3,7,11,88,False,927,Michigan
10,School Totals,200,20,44,.455,13,27,.481,7,17,.412,16,22,.727,5,18,23,16,8,6,10,17,63,False,928,Michigan
13,School Totals,200,25,48,.521,19,30,.633,6,18,.333,18,22,.818,6,24,30,15,6,1,9,13,74,False,929,Michigan
9,School Totals,200,31,50,.620,25,33,.758,6,17,.353,3,9,.333,2,14,16,16,4,1,9,13,71,False,930,Michigan
9,School Totals,200,28,52,.538,19,28,.679,9,24,.375,15,19,.789,7,19,26,18,3,1,6,10,80,False,931,Michigan
10,School Totals,200,29,53,.547,22,40,.550,7,13,.538,12,14,.857,2,27,29,12,6,7,11,14,77,False,932,Michigan
9,School Totals,200,27,58,.466,19,31,.613,8,27,.296,13,16,.813,10,21,31,15,9,2,10,16,75,False,933,Michigan
10,School Totals,200,22,49,.449,11,30,.367,11,19,.579,25,30,.833,7,24,31,14,1,3,11,16,80,False,934,Michigan
9,School Totals,200,28,46,.609,21,33,.636,7,13,.538,12,17,.706,5,23,28,10,7,6,16,14,75,False,935,Michigan
9,School Totals,200,18,45,.400,15,32,.469,3,13,.231,13,18,.722,8,14,22,8,4,2,10,15,52,False,156,Michigan
13,School Totals,200,26,52,.500,13,21,.619,13,31,.419,14,14,1.000,6,24,30,21,5,1,13,10,79,False,936,Michigan
12,School Totals,200,22,52,.423,13,27,.481,9,25,.360,14,18,.778,6,20,26,13,3,4,10,13,67,False,937,Michigan
9,School Totals,200,22,53,.415,14,36,.389,8,17,.471,18,22,.818,14,24,38,8,2,0,8,14,70,False,938,Michigan
9,School Totals,200,20,50,.400,14,34,.412,6,16,.375,16,18,.889,6,22,28,5,0,0,9,16,62,False,939,Michigan
9,School Totals,200,27,54,.500,19,35,.543,8,19,.421,17,25,.680,4,17,21,15,5,0,2,18,79,False,940,Michigan
9,School Totals,225,27,65,.415,21,42,.500,6,23,.261,17,25,.680,12,21,33,19,6,2,7,14,77,False,941,Michigan
9,School Totals,200,25,50,.500,16,27,.593,9,23,.391,7,9,.778,5,23,28,14,2,1,9,14,66,False,942,Michigan
13,School Totals,200,29,51,.569,13,28,.464,16,23,.696,10,14,.714,4,29,33,15,5,1,9,12,84,False,943,Michigan
9,School Totals,200,27,56,.482,23,41,.561,4,15,.267,26,29,.897,10,14,24,13,7,3,4,15,84,False,165,Michigan
10,School Totals,200,21,47,.447,11,17,.647,10,30,.333,12,15,.800,6,20,26,11,4,2,8,15,64,False,944,Michigan
9,School Totals,200,25,47,.532,13,24,.542,12,23,.522,10,19,.526,3,20,23,15,7,3,12,11,72,False,945,Michigan
12,School Totals,200,17,54,.315,11,31,.355,6,23,.261,15,16,.938,10,13,23,7,3,3,9,14,55,False,946,Michigan
12,School Totals,200,22,46,.478,15,29,.517,7,17,.412,6,9,.667,6,25,31,15,8,1,11,8,57,False,947,Michigan
9,School Totals,200,24,54,.444,10,26,.385,14,28,.500,17,21,.810,10,15,25,16,5,2,4,12,79,False,948,Michigan
9,School Totals,200,27,49,.551,16,29,.552,11,20,.550,8,10,.800,4,19,23,14,5,1,12,13,73,False,949,Michigan
10,School Totals,200,27,57,.474,20,39,.513,7,18,.389,11,14,.786,11,9,20,11,4,1,6,14,72,False,950,Michigan
13,School Totals,200,30,58,.517,19,39,.487,11,19,.579,21,25,.840,7,24,31,16,11,4,6,7,92,False,951,Michigan
13,School Totals,200,29,63,.460,21,45,.467,8,18,.444,11,18,.611,10,26,36,18,7,4,6,13,77,False,952,Michigan
10,School Totals,200,23,53,.434,14,29,.483,9,24,.375,16,20,.800,7,28,35,14,3,3,11,13,71,False,953,Michigan
12,School Totals,200,21,46,.457,16,33,.485,5,13,.385,23,29,.793,6,18,24,11,3,3,6,16,70,False,954,Michigan
12,School Totals,200,23,56,.411,17,35,.486,6,21,.286,3,5,.600,4,23,27,10,4,0,11,20,55,False,955,Michigan
12,School Totals,200,32,58,.552,18,34,.529,14,24,.583,13,16,.813,11,22,33,15,7,1,13,15,91,False,956,Michigan
9,School Totals,200,25,65,.385,14,32,.438,11,33,.333,7,12,.583,13,13,26,19,7,1,7,14,68,False,957,Michigan
9,School Totals,200,23,54,.426,12,30,.400,11,24,.458,13,14,.929,7,14,21,8,6,2,7,12,70,False,958,Michigan
11,School Totals,200,14,43,.326,10,22,.455,4,21,.190,10,13,.769,1,25,26,8,9,1,12,15,42,False,959,Michigan
12,School Totals,200,19,54,.352,12,28,.429,7,26,.269,8,13,.615,4,18,22,12,7,1,11,18,53,False,960,Michigan
11,School Totals,200,17,54,.315,9,18,.500,8,36,.222,9,14,.643,8,18,26,12,11,0,14,15,51,False,961,Michigan
13,School Totals,200,25,53,.472,17,27,.630,8,26,.308,14,26,.538,9,29,38,18,3,3,12,10,72,False,962,Michigan
11,School Totals,225,27,66,.409,17,38,.447,10,28,.357,9,14,.643,8,28,36,15,7,1,5,12,73,False,963,Michigan
11,School Totals,200,15,47,.319,7,27,.259,8,20,.400,13,20,.650,4,18,22,9,6,2,10,20,51,False,964,Michigan
11,School Totals,200,24,45,.533,15,30,.500,9,15,.600,16,19,.842,4,24,28,14,4,1,15,14,73,False,965,Michigan
11,School Totals,200,21,52,.404,17,34,.500,4,18,.222,16,20,.800,9,19,28,9,9,2,9,14,62,False,966,Michigan
12,School Totals,200,20,59,.339,14,33,.424,6,26,.231,6,6,1.000,8,19,27,8,2,0,13,16,52,False,967,Michigan
10,School Totals,200,20,58,.345,11,35,.314,9,23,.391,7,11,.636,7,19,26,10,6,2,3,11,56,False,968,Michigan
12,School Totals,200,17,49,.347,9,23,.391,8,26,.308,12,14,.857,9,23,32,9,3,5,11,12,54,False,969,Michigan
12,School Totals,225,23,54,.426,16,34,.471,7,20,.350,11,12,.917,10,19,29,8,2,1,8,20,64,False,970,Michigan
11,School Totals,200,22,46,.478,16,32,.500,6,14,.429,8,8,1.000,5,27,32,12,3,2,12,14,58,False,971,Michigan
10,School Totals,225,27,62,.435,21,42,.500,6,20,.300,6,10,.600,4,21,25,8,5,0,10,19,66,False,972,Michigan
11,School Totals,200,19,47,.404,12,23,.522,7,24,.292,9,11,.818,4,12,16,8,3,2,6,10,54,False,973,Michigan
10,School Totals,200,23,46,.500,17,33,.515,6,13,.462,15,20,.750,5,14,19,13,7,4,11,16,67,False,190,Michigan
10,School Totals,225,21,57,.368,17,40,.425,4,17,.235,6,6,1.000,7,24,31,8,5,1,11,13,52,False,974,Michigan
11,School Totals,200,19,48,.396,11,26,.423,8,22,.364,21,28,.750,8,14,22,10,6,1,6,18,67,False,975,Michigan
11,School Totals,200,26,55,.473,19,36,.528,7,19,.368,5,8,.625,8,20,28,13,5,1,8,11,64,False,976,Michigan
11,School Totals,200,19,52,.365,14,31,.452,5,21,.238,13,15,.867,9,20,29,6,4,1,10,13,56,False,588,Michigan
10,School Totals,249,25,56,.446,14,32,.438,11,24,.458,17,21,.810,6,23,29,13,5,1,11,15,78,False,977,Michigan
13,School Totals,200,29,57,.509,15,26,.577,14,31,.452,7,10,.700,4,21,25,20,4,1,6,13,79,False,978,Michigan
11,School Totals,200,29,59,.492,22,44,.500,7,15,.467,8,8,1.000,6,24,30,15,5,3,6,13,73,False,979,Michigan
9,School Totals,200,27,52,.519,21,37,.568,6,15,.400,0,2,.000,3,15,18,13,5,3,5,13,60,False,980,Michigan
12,School Totals,200,27,52,.519,21,36,.583,6,16,.375,10,15,.667,6,24,30,15,9,5,12,13,70,False,981,Michigan
13,School Totals,200,31,60,.517,18,36,.500,13,24,.542,13,15,.867,8,20,28,20,8,1,11,22,88,False,982,Michigan
13,School Totals,200,21,52,.404,11,26,.423,10,26,.385,18,26,.692,5,21,26,8,7,2,11,23,70,False,983,Michigan
12,School Totals,200,18,56,.321,10,27,.370,8,29,.276,16,20,.800,10,20,30,8,3,3,9,16,60,False,984,Michigan
13,School Totals,200,39,63,.619,27,40,.675,12,23,.522,12,14,.857,5,33,38,21,4,5,8,16,102,False,985,Michigan
13,School Totals,200,29,50,.580,15,25,.600,14,25,.560,6,12,.500,6,21,27,15,5,0,10,19,78,False,986,Michigan
12,School Totals,200,24,48,.500,17,28,.607,7,20,.350,11,13,.846,2,28,30,15,3,2,11,20,66,False,987,Michigan
12,School Totals,200,28,58,.483,17,35,.486,11,23,.478,15,20,.750,5,21,26,14,6,6,6,16,82,False,988,Michigan
12,School Totals,200,21,60,.350,11,24,.458,10,36,.278,6,12,.500,8,12,20,12,10,2,8,13,58,False,989,Michigan
11,School Totals,200,32,61,.525,21,34,.618,11,27,.407,5,10,.500,6,32,38,23,6,2,7,12,80,False,990,Michigan
12,School Totals,200,28,53,.528,20,35,.571,8,18,.444,13,18,.722,8,21,29,14,5,1,10,10,77,False,991,Michigan
13,School Totals,200,40,65,.615,28,35,.800,12,30,.400,13,18,.722,8,36,44,29,7,3,6,11,105,False,992,Michigan
13,School Totals,200,37,63,.587,20,28,.714,17,35,.486,5,7,.714,9,24,33,26,5,0,8,16,96,False,993,Michigan
10,School Totals,200,30,62,.484,20,38,.526,10,24,.417,8,10,.800,9,27,36,16,7,3,14,14,78,False,994,Michigan
12,School Totals,200,29,49,.592,15,24,.625,14,25,.560,7,11,.636,2,24,26,18,5,2,12,12,79,False,995,Michigan
11,School Totals,200,23,61,.377,12,34,.353,11,27,.407,13,16,.813,8,18,26,10,7,2,7,21,70,False,996,Michigan
11,School Totals,200,25,53,.472,13,24,.542,12,29,.414,8,13,.615,7,20,27,12,7,4,6,12,70,False,610,Michigan
11,School Totals,200,25,54,.463,15,26,.577,10,28,.357,11,14,.786,8,21,29,18,1,3,13,14,71,False,997,Michigan
11,School Totals,200,23,63,.365,14,32,.438,9,31,.290,19,23,.826,7,29,36,9,4,2,6,18,74,False,998,Michigan
11,School Totals,200,25,47,.532,14,26,.538,11,21,.524,20,23,.870,8,23,31,18,6,2,12,15,81,False,999,Michigan
10,School Totals,200,20,49,.408,9,21,.429,11,28,.393,17,20,.850,4,24,28,17,3,2,9,13,68,False,1000,Michigan
10,School Totals,200,25,55,.455,19,35,.543,6,20,.300,23,31,.742,10,20,30,13,7,2,7,14,79,False,1001,Michigan
12,School Totals,200,27,62,.435,20,39,.513,7,23,.304,6,11,.545,6,22,28,11,2,2,10,13,67,False,223,Michigan
12,School Totals,200,26,58,.448,18,30,.600,8,28,.286,13,16,.813,5,13,18,10,11,0,7,18,73,False,1002,Michigan
10,School Totals,200,28,52,.538,14,27,.519,14,25,.560,12,20,.600,2,25,27,17,6,2,9,17,82,False,1003,Michigan
12,School Totals,200,20,55,.364,15,35,.429,5,20,.250,16,22,.727,9,25,34,7,5,1,6,15,61,False,1004,Michigan
10,School Totals,200,23,59,.390,18,35,.514,5,24,.208,15,18,.833,10,22,32,11,3,1,9,20,66,False,1005,Michigan
12,School Totals,200,32,68,.471,19,41,.463,13,27,.481,5,8,.625,9,16,25,22,9,5,15,17,82,False,621,Michigan
10,School Totals,200,24,49,.490,20,34,.588,4,15,.267,20,25,.800,7,22,29,8,2,0,8,11,72,False,1006,Michigan
11,School Totals,200,24,50,.480,19,37,.514,5,13,.385,4,7,.571,2,17,19,14,5,1,11,16,57,False,1007,Michigan
11,School Totals,200,23,64,.359,15,30,.500,8,34,.235,7,12,.583,10,30,40,13,4,1,11,13,61,False,1008,Michigan
12,School Totals,225,22,58,.379,10,29,.345,12,29,.414,16,20,.800,7,28,35,14,3,2,8,15,72,False,1009,Michigan
11,School Totals,200,26,56,.464,20,35,.571,6,21,.286,14,16,.875,8,11,19,18,7,3,9,20,72,False,232,Michigan
12,School Totals,200,23,61,.377,17,36,.472,6,25,.240,7,12,.583,5,19,24,13,6,2,8,15,59,False,1010,Michigan
11,School Totals,200,24,59,.407,18,34,.529,6,25,.240,13,16,.813,8,25,33,10,5,6,8,14,67,False,1011,Michigan
10,School Totals,200,25,63,.397,15,36,.417,10,27,.370,3,5,.600,8,14,22,18,10,1,6,14,63,False,1012,Michigan
14,School Totals,200,22,52,.423,13,28,.464,9,24,.375,23,26,.885,10,17,27,16,9,4,10,21,76,False,1013,Michigan
14,School Totals,200,27,60,.450,20,39,.513,7,21,.333,16,18,.889,10,29,39,10,4,7,9,15,77,False,1014,Michigan
14,School Totals,200,27,53,.509,18,30,.600,9,23,.391,16,20,.800,5,28,33,15,3,5,17,17,79,False,1015,Michigan
14,School Totals,200,27,51,.529,14,20,.700,13,31,.419,9,11,.818,2,22,24,14,7,3,4,11,76,False,1016,Michigan
12,School Totals,200,10,52,.192,8,26,.308,2,26,.077,24,32,.750,15,15,30,2,7,0,15,17,46,False,1017,Michigan
10,School Totals,200,24,55,.436,13,28,.464,11,27,.407,5,6,.833,8,25,33,14,4,2,12,8,64,False,1018,Michigan
11,School Totals,200,28,59,.475,18,32,.563,10,27,.370,4,7,.571,7,18,25,11,3,1,9,21,70,False,1019,Michigan
14,School Totals,200,30,53,.566,21,33,.636,9,20,.450,13,17,.765,7,23,30,15,4,2,7,12,82,False,1020,Michigan
9,School Totals,200,20,48,.417,14,29,.483,6,19,.316,7,11,.636,3,22,25,12,8,3,12,9,53,False,1021,Michigan
13,School Totals,200,29,58,.500,15,32,.469,14,26,.538,12,13,.923,7,14,21,16,6,0,6,17,84,False,1022,Michigan
14,School Totals,200,32,62,.516,13,17,.765,19,45,.422,14,18,.778,8,27,35,22,6,2,6,9,97,False,1023,Michigan
14,School Totals,200,34,52,.654,22,31,.710,12,21,.571,18,26,.692,5,29,34,28,7,5,9,12,98,False,1024,Michigan
9,School Totals,200,24,55,.436,20,35,.571,4,20,.200,16,16,1.000,7,17,24,13,5,0,5,13,68,False,1025,Michigan
10,School Totals,225,34,74,.459,22,39,.564,12,35,.343,3,5,.600,13,23,36,21,7,2,8,16,83,False,1026,Michigan
10,School Totals,200,25,56,.446,19,35,.543,6,21,.286,16,21,.762,5,20,25,10,9,3,5,14,72,False,1027,Michigan
9,School Totals,200,28,56,.500,20,35,.571,8,21,.381,6,10,.600,6,16,22,10,7,4,9,13,70,False,644,Michigan
14,School Totals,200,27,51,.529,20,37,.541,7,14,.500,8,10,.800,4,13,17,12,6,0,8,15,69,False,1028,Michigan
10,School Totals,200,27,50,.540,16,28,.571,11,22,.500,26,30,.867,3,18,21,13,5,4,10,15,91,False,1029,Michigan
11,School Totals,200,22,51,.431,12,30,.400,10,21,.476,10,11,.909,4,26,30,10,3,4,10,21,64,False,1030,Michigan
11,School Totals,200,23,51,.451,17,30,.567,6,21,.286,14,22,.636,9,19,28,8,5,2,13,21,66,False,1031,Michigan
13,School Totals,200,31,49,.633,20,29,.690,11,20,.550,17,24,.708,7,12,19,14,7,6,5,12,90,False,256,Michigan
12,School Totals,200,19,56,.339,12,30,.400,7,26,.269,17,19,.895,12,16,28,9,3,3,12,21,62,False,1032,Michigan
9,School Totals,200,19,51,.373,6,16,.375,13,35,.371,15,18,.833,7,17,24,10,4,2,11,22,66,False,1033,Michigan
14,School Totals,200,32,53,.604,22,32,.688,10,21,.476,12,14,.857,2,20,22,18,6,1,8,11,86,False,1034,Michigan
12,School Totals,200,26,55,.473,18,33,.545,8,22,.364,15,19,.789,7,20,27,13,8,3,8,16,75,False,261,Michigan
10,School Totals,200,23,50,.460,14,27,.519,9,23,.391,9,13,.692,5,20,25,15,6,3,9,14,64,False,1035,Michigan
9,School Totals,225,30,60,.500,21,34,.618,9,26,.346,9,18,.500,2,28,30,17,6,1,8,27,78,False,1036,Michigan
9,School Totals,200,22,54,.407,12,23,.522,10,31,.323,14,23,.609,10,25,35,14,3,3,11,11,68,False,1037,Michigan
10,School Totals,200,30,55,.545,19,29,.655,11,26,.423,11,11,1.000,3,20,23,12,5,2,8,10,82,False,1038,Michigan
9,School Totals,200,23,51,.451,15,29,.517,8,22,.364,11,17,.647,5,19,24,13,5,5,7,15,65,False,1039,Michigan
13,School Totals,200,34,54,.630,20,27,.741,14,27,.519,11,14,.786,7,21,28,20,12,5,10,16,93,False,1040,Michigan
9,School Totals,200,30,56,.536,21,31,.677,9,25,.360,6,7,.857,5,20,25,16,10,0,7,11,75,False,1041,Michigan
11,School Totals,225,25,60,.417,19,35,.543,6,25,.240,18,23,.783,10,25,35,6,6,4,13,15,74,False,1042,Michigan
9,School Totals,200,29,54,.537,21,31,.677,8,23,.348,18,22,.818,2,20,22,15,5,3,8,15,84,False,1043,Michigan
9,School Totals,200,27,48,.563,17,25,.680,10,23,.435,7,9,.778,2,22,24,17,7,2,8,13,71,False,1044,Michigan
9,School Totals,200,29,56,.518,13,27,.481,16,29,.552,18,22,.818,3,13,16,19,5,6,4,14,92,False,1045,Michigan
9,School Totals,200,28,57,.491,22,40,.550,6,17,.353,11,14,.786,6,17,23,11,4,4,6,15,73,False,1046,Michigan
9,School Totals,200,25,58,.431,14,27,.519,11,31,.355,7,7,1.000,2,27,29,16,3,2,8,16,68,False,1047,Michigan
13,School Totals,200,33,71,.465,24,46,.522,9,25,.360,11,16,.688,12,23,35,21,12,2,10,12,86,False,1048,Michigan
11,School Totals,200,26,59,.441,16,25,.640,10,34,.294,10,12,.833,6,19,25,14,5,3,4,11,72,False,1049,Michigan
12,School Totals,200,23,47,.489,15,24,.625,8,23,.348,7,9,.778,8,23,31,13,5,3,9,10,61,False,1050,Michigan
12,School Totals,200,27,59,.458,21,36,.583,6,23,.261,15,21,.714,13,14,27,12,6,1,7,20,75,False,1051,Michigan
14,School Totals,200,37,57,.649,22,29,.759,15,28,.536,13,18,.722,6,26,32,22,9,6,8,12,102,False,1052,Michigan
11,School Totals,200,25,53,.472,20,33,.606,5,20,.250,13,22,.591,7,25,32,10,6,4,10,14,68,False,1053,Michigan
17,School Totals,200,34,63,.540,21,35,.600,13,28,.464,6,11,.545,10,32,42,24,10,7,11,6,87,False,1054,Michigan
14,School Totals,200,28,66,.424,18,32,.563,10,34,.294,5,11,.455,9,18,27,16,8,6,10,16,71,False,1055,Michigan
11,School Totals,200,26,55,.473,15,24,.625,11,31,.355,6,10,.600,4,28,32,16,5,3,10,15,69,False,277,Michigan
12,School Totals,200,22,59,.373,14,31,.452,8,28,.286,10,14,.714,11,20,31,13,5,0,8,20,62,False,1056,Michigan
11,School Totals,225,30,64,.469,20,35,.571,10,29,.345,8,22,.364,5,22,27,15,12,0,11,18,78,False,1057,Michigan
11,School Totals,200,22,55,.400,16,36,.444,6,19,.316,9,12,.750,9,29,38,9,3,3,10,17,59,False,1058,Michigan
13,School Totals,200,34,72,.472,23,49,.469,11,23,.478,11,19,.579,13,28,41,19,11,5,9,18,90,False,1059,Michigan
17,School Totals,200,36,60,.600,21,28,.750,15,32,.469,10,18,.556,5,26,31,23,10,5,12,16,97,False,1060,Michigan
13,School Totals,200,31,55,.564,23,32,.719,8,23,.348,6,9,.667,7,31,38,15,3,5,14,7,76,False,1061,Michigan
11,School Totals,200,28,57,.491,17,32,.531,11,25,.440,8,10,.800,6,24,30,18,8,0,7,15,75,False,1062,Michigan
12,School Totals,200,26,51,.510,18,31,.581,8,20,.400,19,24,.792,5,19,24,18,7,5,15,17,79,False,1063,Michigan
10,School Totals,200,26,58,.448,16,36,.444,10,22,.455,7,11,.636,9,25,34,9,2,2,9,10,69,False,1064,Michigan
11,School Totals,200,24,57,.421,18,42,.429,6,15,.400,28,35,.800,8,19,27,13,6,4,7,25,82,False,1065,Michigan
11,School Totals,200,25,61,.410,14,35,.400,11,26,.423,7,12,.583,6,23,29,14,2,6,6,15,68,False,680,Michigan
12,School Totals,200,21,56,.375,17,38,.447,4,18,.222,6,10,.600,14,18,32,6,4,2,12,19,52,False,1066,Michigan
11,School Totals,200,23,54,.426,15,29,.517,8,25,.320,8,11,.727,5,26,31,16,4,2,9,15,62,False,1067,Michigan
10,School Totals,200,35,58,.603,22,35,.629,13,23,.565,5,9,.556,7,14,21,14,5,3,11,20,88,False,1068,Michigan
10,School Totals,200,21,50,.420,14,25,.560,7,25,.280,9,14,.643,4,24,28,13,8,1,5,13,58,False,1069,Michigan
10,School Totals,225,28,63,.444,20,31,.645,8,32,.250,12,28,.429,10,29,39,12,1,2,6,16,76,False,1070,Michigan
11,School Totals,200,17,44,.386,12,22,.545,5,22,.227,13,19,.684,5,22,27,13,4,2,8,18,52,False,1071,Michigan
11,School Totals,200,28,50,.560,19,30,.633,9,20,.450,18,24,.750,8,24,32,15,2,3,8,16,83,False,1072,Michigan
10,School Totals,200,28,67,.418,16,34,.471,12,33,.364,6,12,.500,10,21,31,19,13,2,5,13,74,False,1073,Michigan
10,School Totals,200,25,52,.481,18,32,.563,7,20,.350,17,24,.708,2,25,27,12,6,2,6,17,74,False,1074,Michigan
11,School Totals,200,23,51,.451,13,30,.433,10,21,.476,16,19,.842,5,27,32,15,8,6,11,15,72,False,1075,Michigan
13,School Totals,200,29,57,.509,14,26,.538,15,31,.484,12,16,.750,8,21,29,18,6,5,8,18,85,False,690,Michigan
10,School Totals,225,28,62,.452,25,43,.581,3,19,.158,18,32,.563,10,31,41,11,8,2,7,22,77,False,1076,Michigan
13,School Totals,200,27,61,.443,16,38,.421,11,23,.478,12,15,.800,12,26,38,12,4,6,9,20,77,False,1077,Michigan
10,School Totals,200,21,47,.447,12,22,.545,9,25,.360,24,33,.727,4,30,34,10,5,1,8,13,75,False,1078,Michigan
11,School Totals,200,26,52,.500,18,29,.621,8,23,.348,15,25,.600,4,19,23,18,6,2,5,16,75,False,1079,Michigan
11,School Totals,200,21,47,.447,16,31,.516,5,16,.313,14,22,.636,5,30,35,11,4,3,13,14,61,False,1080,Michigan
11,School Totals,200,21,59,.356,13,29,.448,8,30,.267,14,20,.700,7,26,33,13,4,5,7,22,64,False,1081,Michigan
14,School Totals,200,39,63,.619,25,39,.641,14,24,.583,7,8,.875,2,24,26,21,12,0,6,15,99,False,1082,Michigan
10,School Totals,200,19,49,.388,15,27,.556,4,22,.182,16,24,.667,7,23,30,8,6,4,10,16,58,False,1083,Michigan
14,School Totals,200,25,59,.424,18,31,.581,7,28,.250,12,18,.667,10,25,35,8,10,2,11,11,69,False,1084,Michigan
14,School Totals,200,24,55,.436,21,32,.656,3,23,.130,11,18,.611,5,21,26,6,6,1,10,20,62,False,1085,Michigan
14,School Totals,194,22,60,.367,16,34,.471,6,26,.231,13,29,.448,13,34,47,16,3,8,11,18,63,False,1086,Michigan
12,School Totals,200,18,50,.360,15,31,.484,3,19,.158,17,21,.810,6,32,38,13,6,9,9,8,56,False,1087,Michigan
14,School Totals,200,28,55,.509,23,38,.605,5,17,.294,12,19,.632,7,20,27,13,11,6,7,20,73,False,1088,Michigan
14,School Totals,200,31,62,.500,16,32,.500,15,30,.500,7,11,.636,8,30,38,20,6,2,10,12,84,False,1089,Michigan
14,School Totals,200,23,52,.442,17,34,.500,6,18,.333,14,20,.700,8,25,33,15,3,3,9,18,66,False,1090,Michigan
15,School Totals,200,29,59,.492,21,37,.568,8,22,.364,17,24,.708,10,32,42,13,10,2,5,5,83,False,1091,Michigan
9,School Totals,200,31,54,.574,20,32,.625,11,22,.500,11,23,.478,2,24,26,15,4,6,7,14,84,False,1092,Michigan
14,School Totals,200,26,55,.473,13,29,.448,13,26,.500,11,13,.846,5,25,30,15,3,2,11,9,76,False,1093,Michigan
9,School Totals,200,24,55,.436,19,35,.543,5,20,.250,9,13,.692,8,22,30,12,6,1,8,15,62,False,1094,Michigan
9,School Totals,200,28,54,.519,18,30,.600,10,24,.417,23,30,.767,10,24,34,13,5,4,16,14,89,False,1095,Michigan
9,School Totals,200,24,54,.444,17,36,.472,7,18,.389,15,25,.600,6,23,29,8,10,2,8,14,70,False,1096,Michigan
13,School Totals,200,28,60,.467,18,28,.643,10,32,.313,5,7,.714,11,19,30,15,9,5,11,14,71,False,1097,Michigan
13,School Totals,200,30,63,.476,19,45,.422,11,18,.611,3,6,.500,9,26,35,23,8,4,7,12,74,False,1098,Michigan
9,School Totals,200,25,55,.455,20,41,.488,5,14,.357,13,19,.684,3,26,29,10,8,6,10,13,68,False,1099,Michigan
10,School Totals,200,29,58,.500,25,42,.595,4,16,.250,12,16,.750,7,22,29,9,4,3,2,16,74,False,315,Michigan
9,School Totals,200,28,62,.452,23,43,.535,5,19,.263,18,22,.818,9,25,34,16,4,6,12,16,79,False,1100,Michigan
14,School Totals,200,31,59,.525,20,32,.625,11,27,.407,7,9,.778,8,22,30,14,10,4,9,13,80,False,1101,Michigan
9,School Totals,200,22,54,.407,17,36,.472,5,18,.278,5,11,.455,8,25,33,11,6,7,16,17,54,False,1102,Michigan
9,School Totals,200,21,62,.339,18,40,.450,3,22,.136,14,22,.636,10,20,30,7,9,4,6,13,59,False,1103,Michigan
14,School Totals,200,25,58,.431,15,29,.517,10,29,.345,9,12,.750,3,35,38,10,5,4,9,18,69,False,320,Michigan
13,School Totals,200,22,54,.407,12,27,.444,10,27,.370,11,12,.917,6,21,27,15,11,3,8,14,65,False,1104,Michigan
13,School Totals,200,21,65,.323,13,32,.406,8,33,.242,9,12,.750,6,29,35,11,5,3,8,20,59,False,1105,Michigan
9,School Totals,200,26,58,.448,15,35,.429,11,23,.478,14,17,.824,4,25,29,14,3,5,7,17,77,False,1106,Michigan
9,School Totals,200,25,56,.446,21,39,.538,4,17,.235,7,9,.778,5,29,34,11,5,5,5,9,61,False,1107,Michigan
9,School Totals,200,25,49,.510,18,29,.621,7,20,.350,12,16,.750,4,21,25,10,5,3,12,19,69,False,1108,Michigan
10,School Totals,200,25,59,.424,18,33,.545,7,26,.269,8,10,.800,6,24,30,15,7,4,5,13,65,False,716,Michigan
10,School Totals,200,25,57,.439,12,29,.414,13,28,.464,6,11,.545,4,30,34,20,6,7,9,13,69,False,1109,Michigan
10,School Totals,200,23,58,.397,16,32,.500,7,26,.269,17,20,.850,9,19,28,6,3,2,8,18,70,False,1110,Michigan
15,School Totals,200,30,54,.556,18,32,.563,12,22,.545,10,19,.526,7,35,42,19,3,4,12,10,82,False,1111,Michigan
9,School Totals,200,25,57,.439,19,37,.514,6,20,.300,13,15,.867,9,19,28,14,4,3,3,12,69,False,720,Michigan
12,School Totals,200,25,62,.403,17,40,.425,8,22,.364,5,7,.714,3,15,18,10,8,1,5,20,63,False,1112,Michigan
15,School Totals,200,28,62,.452,18,32,.563,10,30,.333,8,12,.667,5,32,37,24,9,4,6,14,74,False,1113,Michigan
15,School Totals,200,32,62,.516,22,36,.611,10,26,.385,2,2,1.000,7,27,34,21,5,6,7,8,76,False,1114,Michigan
9,School Totals,200,21,51,.412,13,26,.500,8,25,.320,10,12,.833,0,26,26,17,5,5,6,11,60,False,1115,Michigan
15,School Totals,200,25,51,.490,20,34,.588,5,17,.294,19,24,.792,5,33,38,15,6,1,11,14,74,False,1116,Michigan
13,School Totals,200,24,57,.421,17,36,.472,7,21,.333,9,12,.750,10,29,39,13,5,3,8,10,64,False,1117,Michigan
14,School Totals,200,16,49,.327,15,30,.500,1,19,.053,11,17,.647,7,26,33,9,5,2,14,13,44,False,1118,Michigan
9,School Totals,200,29,61,.475,20,36,.556,9,25,.360,12,19,.632,11,21,32,15,8,6,17,18,79,False,1119,Michigan
9,School Totals,200,30,53,.566,21,30,.700,9,23,.391,10,12,.833,3,21,24,16,3,6,11,7,79,False,1120,Michigan
11,School Totals,200,28,58,.483,21,35,.600,7,23,.304,7,10,.700,7,28,35,12,3,6,10,7,70,False,1121,Michigan
15,School Totals,200,43,77,.558,29,48,.604,14,29,.483,11,16,.688,11,31,42,29,9,4,12,12,111,False,1122,Michigan
11,School Totals,200,30,52,.577,20,31,.645,10,21,.476,13,18,.722,3,32,35,18,5,3,22,19,83,False,1123,Michigan
9,School Totals,200,28,56,.500,17,30,.567,11,26,.423,6,10,.600,5,26,31,15,7,7,15,18,73,False,1124,Michigan
12,School Totals,200,34,63,.540,22,40,.550,12,23,.522,2,5,.400,7,28,35,17,5,6,11,12,82,False,1125,Michigan
12,School Totals,200,15,58,.259,12,39,.308,3,19,.158,10,15,.667,8,30,38,6,4,3,10,14,43,False,1126,Michigan
10,School Totals,200,32,58,.552,22,34,.647,10,24,.417,29,34,.853,11,25,36,21,4,6,9,19,103,False,1127,Michigan
10,School Totals,200,27,62,.435,24,44,.545,3,18,.167,5,6,.833,5,19,24,12,6,5,8,18,62,False,1128,Michigan
10,School Totals,225,25,61,.410,16,40,.400,9,21,.429,11,14,.786,6,21,27,14,4,3,11,12,70,False,1129,Michigan
15,School Totals,200,28,53,.528,17,26,.654,11,27,.407,19,25,.760,12,30,42,14,7,6,8,12,86,False,1130,Michigan
15,School Totals,200,36,67,.537,28,46,.609,8,21,.381,6,7,.857,10,28,38,19,4,2,14,12,86,False,1131,Michigan
12,School Totals,200,25,69,.362,20,46,.435,5,23,.217,14,22,.636,12,19,31,14,7,5,10,22,69,False,1132,Michigan
10,School Totals,250,31,66,.470,24,37,.649,7,29,.241,15,24,.625,4,22,26,17,7,7,9,17,84,False,1133,Michigan
10,School Totals,200,26,62,.419,16,34,.471,10,28,.357,5,6,.833,6,20,26,14,4,2,8,19,67,False,1134,Michigan
10,School Totals,200,34,68,.500,23,34,.676,11,34,.324,4,5,.800,6,18,24,24,8,5,8,22,83,False,1135,Michigan
8,School Totals,200,24,68,.353,19,40,.475,5,28,.179,10,14,.714,10,26,36,9,8,1,13,14,63,False,1136,Michigan
10,School Totals,200,23,59,.390,19,42,.452,4,17,.235,12,21,.571,10,26,36,5,3,3,2,14,62,False,1137,Michigan
10,School Totals,200,28,56,.500,21,32,.656,7,24,.292,16,24,.667,10,29,39,13,9,6,15,16,79,False,1138,Michigan
9,School Totals,200,22,47,.468,13,28,.464,9,19,.474,16,24,.667,4,28,32,17,6,6,15,12,69,False,1139,Michigan
9,School Totals,200,20,60,.333,10,29,.345,10,31,.323,8,9,.889,9,29,38,10,3,5,12,14,58,False,1140,Michigan
9,School Totals,200,24,64,.375,13,36,.361,11,28,.393,18,23,.783,11,29,40,12,3,6,9,17,77,False,1141,Michigan
12,School Totals,200,30,64,.469,23,44,.523,7,20,.350,12,15,.800,6,36,42,21,3,3,8,14,79,False,1142,Michigan
13,School Totals,200,31,54,.574,22,37,.595,9,17,.529,18,22,.818,9,26,35,17,2,6,8,16,89,False,360,Michigan
10,School Totals,200,21,47,.447,15,24,.625,6,23,.261,12,18,.667,4,27,31,6,6,4,10,13,60,False,1143,Michigan
9,School Totals,200,25,65,.385,19,40,.475,6,25,.240,15,23,.652,9,25,34,17,7,3,3,13,71,False,1144,Michigan
9,School Totals,200,31,60,.517,28,50,.560,3,10,.300,9,15,.600,4,23,27,8,5,4,5,17,74,False,1145,Michigan
10,School Totals,200,25,56,.446,18,30,.600,7,26,.269,6,8,.750,4,26,30,16,5,3,12,18,63,False,1146,Michigan
14,School Totals,200,32,70,.457,24,43,.558,8,27,.296,10,14,.714,8,28,36,16,10,6,11,13,82,False,1147,Michigan
9,School Totals,200,24,50,.480,18,30,.600,6,20,.300,16,20,.800,3,17,20,10,4,2,7,19,70,False,753,Michigan
11,School Totals,200,33,61,.541,23,34,.676,10,27,.370,20,26,.769,9,33,42,23,3,3,10,16,96,False,1148,Michigan
11,School Totals,225,29,62,.468,21,35,.600,8,27,.296,15,22,.682,9,33,42,24,7,5,20,20,81,False,1149,Michigan
14,School Totals,200,33,59,.559,29,44,.659,4,15,.267,14,19,.737,9,31,40,12,4,4,12,18,84,False,1150,Michigan
14,School Totals,200,32,65,.492,23,38,.605,9,27,.333,7,8,.875,12,28,40,18,3,4,10,14,80,False,1151,Michigan
13,School Totals,200,34,59,.576,25,43,.581,9,16,.563,14,18,.778,8,24,32,20,7,9,8,13,91,False,1152,Michigan
9,School Totals,200,20,45,.444,15,31,.484,5,14,.357,17,20,.850,4,31,35,13,0,8,15,16,62,False,1153,Michigan
9,School Totals,200,30,59,.508,21,32,.656,9,27,.333,11,14,.786,7,33,40,16,6,2,15,16,80,False,1154,Michigan
8,School Totals,200,30,51,.588,24,32,.750,6,19,.316,18,20,.900,5,24,29,15,5,6,12,10,84,False,763,Michigan
14,School Totals,200,32,64,.500,20,37,.541,12,27,.444,9,14,.643,12,29,41,22,4,8,11,15,85,False,1155,Michigan
13,School Totals,200,33,58,.569,29,45,.644,4,13,.308,12,15,.800,9,26,35,17,4,4,13,10,82,False,1156,Michigan
14,School Totals,200,32,62,.516,23,46,.500,9,16,.563,4,4,1.000,8,33,41,13,6,9,8,9,77,False,1157,Michigan
13,School Totals,200,22,56,.393,16,34,.471,6,22,.273,7,14,.500,12,24,36,16,4,1,19,15,57,False,1158,Michigan
14,School Totals,200,29,56,.518,17,32,.531,12,24,.500,17,22,.773,5,29,34,20,6,5,9,22,87,False,767,Michigan
10,School Totals,200,24,55,.436,18,40,.450,6,15,.400,14,17,.824,8,29,37,14,6,5,14,18,68,False,1159,Michigan
9,School Totals,200,24,59,.407,17,42,.405,7,17,.412,12,16,.750,9,23,32,11,5,6,5,10,67,False,1160,Michigan
10,School Totals,200,24,52,.462,18,37,.486,6,15,.400,17,23,.739,5,30,35,12,2,4,11,17,71,False,1161,Michigan
9,School Totals,200,31,58,.534,20,35,.571,11,23,.478,19,24,.792,9,19,28,19,1,2,7,13,92,False,1162,Michigan
14,School Totals,200,33,70,.471,25,53,.472,8,17,.471,5,6,.833,12,27,39,13,5,2,6,13,79,False,1163,Michigan
14,School Totals,200,24,53,.453,16,32,.500,8,21,.381,17,19,.895,7,27,34,8,8,3,11,15,73,False,391,Michigan
14,School Totals,200,17,49,.347,15,42,.357,2,7,.286,17,24,.708,3,21,24,4,5,4,10,14,53,False,1164,Michigan
14,School Totals,200,26,52,.500,19,36,.528,7,16,.438,10,14,.714,7,27,34,9,4,1,14,20,69,False,1165,Michigan
10,School Totals,200,25,60,.417,18,38,.474,7,22,.318,7,11,.636,9,21,30,17,2,2,8,15,64,False,1166,Michigan
9,School Totals,200,31,60,.517,21,38,.553,10,22,.455,7,7,1.000,9,22,31,21,6,1,6,8,79,False,781,Michigan
9,School Totals,200,20,57,.351,14,38,.368,6,19,.316,21,23,.913,7,26,33,14,3,5,2,16,67,False,1167,Michigan
10,School Totals,200,26,54,.481,17,28,.607,9,26,.346,21,26,.808,9,24,33,19,4,4,14,21,82,False,1168,Michigan
9,School Totals,200,28,52,.538,18,27,.667,10,25,.400,20,25,.800,5,29,34,22,1,4,11,17,86,False,1169,Michigan
13,School Totals,200,29,59,.492,26,48,.542,3,11,.273,15,23,.652,9,25,34,19,4,3,7,10,76,False,1170,Michigan
8,School Totals,200,20,51,.392,17,40,.425,3,11,.273,6,11,.545,8,24,32,12,5,3,14,11,49,False,1171,Michigan
15,School Totals,200,33,71,.465,25,45,.556,8,26,.308,23,37,.622,19,31,50,21,7,3,13,21,97,False,1172,Michigan State
11,School Totals,200,25,57,.439,22,46,.478,3,11,.273,22,31,.710,12,31,43,15,6,5,20,22,75,False,1173,Michigan State
14,School Totals,200,30,66,.455,26,49,.531,4,17,.235,11,26,.423,14,24,38,22,5,4,6,15,75,False,1174,Michigan State
16,School Totals,206,33,60,.550,26,43,.605,7,17,.412,19,28,.679,13,30,43,22,5,8,13,16,92,False,1175,Michigan State
11,School Totals,200,31,59,.525,29,49,.592,2,10,.200,10,14,.714,16,22,38,18,5,1,22,18,74,False,1176,Michigan State
15,School Totals,200,41,70,.586,27,48,.563,14,22,.636,10,16,.625,11,24,35,27,6,2,11,21,106,False,1177,Michigan State
11,School Totals,200,34,79,.430,32,59,.542,2,20,.100,12,16,.750,15,19,34,16,15,2,11,24,82,False,1178,Michigan State
15,School Totals,200,30,55,.545,24,40,.600,6,15,.400,6,9,.667,13,27,40,21,1,6,19,13,72,False,1179,Michigan State
12,School Totals,200,23,42,.548,18,31,.581,5,11,.455,18,28,.643,12,23,35,13,5,4,11,13,69,False,1180,Michigan State
15,School Totals,200,36,64,.563,32,51,.627,4,13,.308,12,18,.667,13,27,40,20,12,2,12,18,88,False,1181,Michigan State
14,School Totals,200,28,57,.491,24,47,.511,4,10,.400,20,25,.800,11,28,39,22,11,3,14,18,80,False,1182,Michigan State
11,School Totals,200,23,52,.442,17,37,.459,6,15,.400,16,20,.800,4,19,23,12,8,0,22,18,68,False,1183,Michigan State
15,School Totals,200,31,61,.508,24,41,.585,7,20,.350,18,26,.692,15,19,34,21,10,3,15,17,87,False,1184,Michigan State
15,School Totals,200,31,54,.574,24,38,.632,7,16,.438,22,30,.733,9,30,39,22,6,7,14,22,91,False,1185,Michigan State
11,School Totals,200,16,42,.381,14,38,.368,2,4,.500,20,30,.667,10,28,38,11,3,1,14,15,54,False,1186,Michigan State
15,School Totals,200,27,49,.551,23,38,.605,4,11,.364,13,17,.765,12,25,37,16,5,0,18,14,71,False,1187,Michigan State
11,School Totals,200,21,58,.362,16,40,.400,5,18,.278,13,21,.619,14,19,33,16,6,6,8,13,60,False,1188,Michigan State
15,School Totals,200,25,57,.439,23,45,.511,2,12,.167,21,26,.808,12,27,39,16,8,0,16,19,73,False,1189,Michigan State
12,School Totals,200,28,62,.452,25,50,.500,3,12,.250,11,17,.647,9,24,33,24,5,4,15,19,70,False,1190,Michigan State
11,School Totals,200,24,61,.393,13,37,.351,11,24,.458,6,9,.667,10,22,32,16,5,7,10,12,65,False,1191,Michigan State
11,School Totals,200,24,49,.490,22,37,.595,2,12,.167,7,11,.636,9,29,38,15,2,3,18,14,57,False,801,Michigan State
13,School Totals,200,27,52,.519,24,37,.649,3,15,.200,22,31,.710,13,22,35,19,7,2,9,20,79,False,1192,Michigan State
11,School Totals,200,17,46,.370,15,37,.405,2,9,.222,13,16,.813,11,20,31,11,5,1,13,15,49,False,1193,Michigan State
12,School Totals,200,29,53,.547,23,37,.622,6,16,.375,9,14,.643,11,23,34,14,3,1,18,19,73,False,1194,Michigan State
12,School Totals,200,18,56,.321,13,37,.351,5,19,.263,23,30,.767,12,13,25,9,6,2,9,20,64,False,1195,Michigan State
11,School Totals,200,26,55,.473,19,42,.452,7,13,.538,6,10,.600,10,22,32,18,5,5,9,15,65,False,1196,Michigan State
15,School Totals,200,32,54,.593,29,43,.674,3,11,.273,5,10,.500,10,13,23,13,8,3,8,26,72,False,24,Michigan State
11,School Totals,200,26,63,.413,21,48,.438,5,15,.333,10,18,.556,8,24,32,16,6,1,10,17,67,False,1197,Michigan State
12,School Totals,200,21,52,.404,19,43,.442,2,9,.222,9,10,.900,15,29,44,9,8,4,22,17,53,False,1198,Michigan State
12,School Totals,200,26,59,.441,22,45,.489,4,14,.286,11,15,.733,14,25,39,17,5,1,9,16,67,False,1199,Michigan State
15,School Totals,200,24,53,.453,21,46,.457,3,7,.429,13,17,.765,12,20,32,13,15,3,17,18,64,False,811,Michigan State
12,School Totals,225,22,53,.415,17,38,.447,5,15,.333,18,34,.529,13,20,33,9,11,5,16,20,67,False,1200,Michigan State
12,School Totals,200,20,53,.377,13,34,.382,7,19,.368,23,33,.697,13,24,37,16,5,4,9,22,70,False,1201,Michigan State
12,School Totals,200,32,58,.552,22,40,.550,10,18,.556,11,14,.786,10,25,35,18,3,5,18,19,85,False,426,Michigan State
11,School Totals,200,19,44,.432,12,25,.480,7,19,.368,14,19,.737,5,26,31,15,8,3,10,19,59,False,1202,Michigan State
12,School Totals,200,24,52,.462,18,34,.529,6,18,.333,16,21,.762,11,13,24,12,8,8,11,20,70,False,1203,Michigan State
11,School Totals,200,18,42,.429,14,31,.452,4,11,.364,10,18,.556,6,28,34,11,3,4,16,21,50,False,1204,Michigan State
14,School Totals,200,31,59,.525,25,46,.543,6,13,.462,28,42,.667,9,39,48,18,9,10,20,19,96,False,1205,Michigan State
12,School Totals,200,29,53,.547,22,36,.611,7,17,.412,17,34,.500,11,27,38,23,11,5,19,21,82,False,1206,Michigan State
11,School Totals,200,30,58,.517,22,44,.500,8,14,.571,14,19,.737,9,20,29,13,8,0,12,17,82,False,1207,Michigan State
11,School Totals,200,23,57,.404,17,40,.425,6,17,.353,15,20,.750,11,24,35,12,5,8,13,20,67,False,1208,Michigan State
11,School Totals,200,25,51,.490,17,28,.607,8,23,.348,18,25,.720,9,15,24,11,8,5,19,22,76,False,1209,Michigan State
14,School Totals,200,27,55,.491,17,31,.548,10,24,.417,9,16,.563,7,26,33,22,6,4,17,15,73,False,1210,Michigan State
12,School Totals,200,31,63,.492,22,46,.478,9,17,.529,8,15,.533,15,20,35,16,7,6,20,25,79,False,1211,Michigan State
16,School Totals,200,26,57,.456,14,29,.483,12,28,.429,10,15,.667,17,31,48,21,4,3,21,14,74,False,1212,Michigan State
12,School Totals,200,21,54,.389,14,30,.467,7,24,.292,9,16,.563,6,20,26,14,9,2,16,20,58,False,1213,Michigan State
12,School Totals,200,25,62,.403,19,47,.404,6,15,.400,21,28,.750,11,25,36,16,13,2,8,16,77,False,1214,Michigan State
16,School Totals,200,32,64,.500,24,47,.511,8,17,.471,18,22,.818,12,28,40,18,14,6,10,22,90,False,1215,Michigan State
12,School Totals,200,18,62,.290,15,46,.326,3,16,.188,16,20,.800,16,29,45,10,4,5,16,20,55,False,1216,Michigan State
12,School Totals,200,24,57,.421,16,33,.485,8,24,.333,15,22,.682,11,19,30,21,9,3,8,16,71,False,1217,Michigan State
11,School Totals,200,29,60,.483,23,42,.548,6,18,.333,1,5,.200,10,29,39,20,7,12,14,19,65,False,1218,Michigan State
12,School Totals,200,23,55,.418,17,36,.472,6,19,.316,10,20,.500,10,21,31,14,4,7,11,21,62,False,1219,Michigan State
12,School Totals,224,21,53,.396,16,37,.432,5,16,.313,17,25,.680,11,23,34,15,5,5,11,16,64,False,1220,Michigan State
12,School Totals,225,20,52,.385,13,33,.394,7,19,.368,24,28,.857,8,26,34,15,6,6,15,19,71,False,1221,Michigan State
12,School Totals,200,24,64,.375,17,38,.447,7,26,.269,7,9,.778,17,17,34,12,4,2,9,22,62,False,1222,Michigan State
12,School Totals,200,28,63,.444,18,43,.419,10,20,.500,10,13,.769,14,14,28,18,7,4,11,24,76,False,1223,Michigan State
11,School Totals,200,21,48,.438,16,29,.552,5,19,.263,10,16,.625,6,21,27,11,8,6,12,16,57,False,833,Michigan State
11,School Totals,225,28,66,.424,20,43,.465,8,23,.348,20,27,.741,12,24,36,18,7,6,8,18,84,False,52,Michigan State
11,School Totals,200,19,56,.339,15,38,.395,4,18,.222,10,14,.714,13,14,27,11,5,2,16,14,52,False,1224,Michigan State
11,School Totals,200,20,46,.435,17,32,.531,3,14,.214,13,16,.813,6,11,17,9,3,0,7,20,56,False,1225,Michigan State
11,School Totals,200,22,42,.524,17,29,.586,5,13,.385,26,35,.743,10,22,32,15,3,5,11,17,75,False,1226,Michigan State
11,School Totals,200,27,47,.574,25,42,.595,2,5,.400,5,6,.833,7,22,29,12,3,4,19,26,61,False,1227,Michigan State
11,School Totals,200,21,50,.420,18,35,.514,3,15,.200,16,23,.696,11,26,37,12,3,6,11,12,61,False,1228,Michigan State
11,School Totals,200,18,49,.367,12,25,.480,6,24,.250,11,15,.733,5,23,28,13,11,5,12,19,53,False,1229,Michigan State
11,School Totals,200,19,57,.333,18,46,.391,1,11,.091,8,11,.727,8,24,32,11,5,6,12,14,47,False,1230,Michigan State
15,School Totals,200,30,55,.545,23,41,.561,7,14,.500,18,27,.667,7,26,33,20,5,3,12,23,85,False,1231,Michigan State
11,School Totals,200,20,61,.328,12,39,.308,8,22,.364,15,20,.750,15,29,44,11,3,4,10,22,63,False,842,Michigan State
11,School Totals,200,22,54,.407,18,40,.450,4,14,.286,18,23,.783,15,22,37,12,9,5,15,14,66,False,1232,Michigan State
12,School Totals,200,21,49,.429,14,36,.389,7,13,.538,25,31,.806,8,31,39,13,2,8,8,19,74,False,1233,Michigan State
11,School Totals,200,17,53,.321,9,30,.300,8,23,.348,6,12,.500,8,20,28,12,3,4,9,18,48,False,1234,Michigan State
11,School Totals,200,25,62,.403,15,37,.405,10,25,.400,16,21,.762,11,22,33,20,9,8,16,28,76,False,1235,Michigan State
11,School Totals,200,22,72,.306,20,52,.385,2,20,.100,9,13,.692,19,23,42,8,7,3,15,25,55,False,1236,Michigan State
12,School Totals,200,26,59,.441,22,47,.468,4,12,.333,13,18,.722,9,22,31,8,8,4,21,29,69,False,1237,Michigan State
15,School Totals,200,29,61,.475,20,34,.588,9,27,.333,9,16,.563,13,37,50,22,10,3,18,18,76,False,1238,Michigan State
13,School Totals,200,20,47,.426,16,26,.615,4,21,.190,25,41,.610,7,31,38,15,14,5,16,16,69,False,1239,Michigan State
13,School Totals,200,21,48,.438,17,35,.486,4,13,.308,22,36,.611,10,28,38,14,7,3,16,19,68,False,1240,Michigan State
14,School Totals,200,28,58,.483,26,46,.565,2,12,.167,14,20,.700,12,33,45,14,11,6,16,14,72,False,1241,Michigan State
12,School Totals,200,21,52,.404,13,33,.394,8,19,.421,15,20,.750,11,20,31,11,10,8,12,11,65,False,1242,Michigan State
17,School Totals,200,46,75,.613,38,59,.644,8,16,.500,10,11,.909,16,37,53,35,6,5,10,20,110,False,1243,Michigan State
17,School Totals,200,33,64,.516,25,43,.581,8,21,.381,15,20,.750,19,23,42,25,5,7,12,17,89,False,1244,Michigan State
12,School Totals,200,26,48,.542,20,35,.571,6,13,.462,16,25,.640,5,15,20,18,10,3,15,20,74,False,1245,Michigan State
14,School Totals,200,25,53,.472,20,42,.476,5,11,.455,19,27,.704,11,23,34,16,6,5,15,16,74,False,1246,Michigan State
17,School Totals,200,35,57,.614,27,43,.628,8,14,.571,11,22,.500,8,24,32,25,8,7,10,16,89,False,1247,Michigan State
11,School Totals,200,27,67,.403,23,56,.411,4,11,.364,32,39,.821,22,26,48,16,9,7,12,22,90,False,1248,Michigan State
10,School Totals,200,29,53,.547,24,40,.600,5,13,.385,17,22,.773,8,23,31,14,9,6,9,14,80,False,75,Michigan State
11,School Totals,200,23,50,.460,20,36,.556,3,14,.214,19,21,.905,9,24,33,10,4,4,13,15,68,False,1249,Michigan State
11,School Totals,225,24,60,.400,22,55,.400,2,5,.400,13,20,.650,12,26,38,10,4,5,8,22,63,False,1250,Michigan State
16,School Totals,200,37,60,.617,27,42,.643,10,18,.556,11,15,.733,10,24,34,25,16,3,15,17,95,False,1251,Michigan State
12,School Totals,200,24,52,.462,15,34,.441,9,18,.500,17,27,.630,14,22,36,19,6,4,13,25,74,False,1252,Michigan State
10,School Totals,200,24,50,.480,17,35,.486,7,15,.467,4,5,.800,9,22,31,13,5,1,14,12,59,False,864,Michigan State
17,School Totals,200,30,50,.600,23,37,.622,7,13,.538,16,22,.727,5,27,32,18,6,5,11,19,83,False,1253,Michigan State
15,School Totals,200,26,48,.542,24,37,.649,2,11,.182,14,23,.609,7,25,32,17,10,8,10,17,68,False,1254,Michigan State
11,School Totals,200,14,58,.241,11,44,.250,3,14,.214,10,12,.833,18,25,43,4,3,3,15,18,41,False,1255,Michigan State
12,School Totals,200,24,46,.522,22,36,.611,2,10,.200,14,20,.700,12,27,39,15,7,1,15,14,64,False,868,Michigan State
14,School Totals,200,23,53,.434,15,32,.469,8,21,.381,23,34,.676,14,27,41,16,9,3,13,18,77,False,1256,Michigan State
11,School Totals,200,21,52,.404,17,36,.472,4,16,.250,12,16,.750,10,25,35,8,5,4,16,17,58,False,1257,Michigan State
16,School Totals,200,24,46,.522,22,37,.595,2,9,.222,19,25,.760,6,21,27,13,5,0,10,17,69,False,1258,Michigan State
13,School Totals,200,30,59,.508,25,46,.543,5,13,.385,11,17,.647,10,28,38,16,3,5,8,17,76,False,1259,Michigan State
10,School Totals,200,22,53,.415,17,33,.515,5,20,.250,17,23,.739,7,15,22,15,9,2,5,14,66,False,1260,Michigan State
16,School Totals,200,23,41,.561,14,21,.667,9,20,.450,7,9,.778,3,29,32,14,9,2,16,12,62,False,1261,Michigan State
12,School Totals,200,20,51,.392,15,38,.395,5,13,.385,10,17,.588,12,16,28,9,5,1,13,16,55,False,92,Michigan State
11,School Totals,200,25,55,.455,20,41,.488,5,14,.357,15,21,.714,5,27,32,13,7,8,13,21,70,False,1262,Michigan State
16,School Totals,200,32,55,.582,24,37,.649,8,18,.444,20,27,.741,9,26,35,17,6,8,11,20,92,False,1263,Michigan State
11,School Totals,200,21,42,.500,15,33,.455,6,9,.667,17,23,.739,6,23,29,12,7,5,12,14,65,False,1264,Michigan State
9,School Totals,200,26,54,.481,17,33,.515,9,21,.429,7,14,.500,7,20,27,16,3,5,6,14,68,False,1265,Michigan State
15,School Totals,200,40,68,.588,37,59,.627,3,9,.333,6,9,.667,15,27,42,21,6,0,11,17,89,False,1266,Michigan State
10,School Totals,200,25,46,.543,21,36,.583,4,10,.400,11,17,.647,4,25,29,12,2,1,11,19,65,False,1267,Michigan State
12,School Totals,200,14,49,.286,9,28,.321,5,21,.238,11,12,.917,6,26,32,12,8,7,15,15,44,False,1268,Michigan State
11,School Totals,200,24,64,.375,20,47,.426,4,17,.235,10,13,.769,17,21,38,9,9,3,15,15,62,False,1269,Michigan State
10,School Totals,200,25,48,.521,21,38,.553,4,10,.400,13,17,.765,9,18,27,11,8,6,15,18,67,False,1270,Michigan State
13,School Totals,200,28,60,.467,26,47,.553,2,13,.154,11,15,.733,9,33,42,11,12,7,12,13,69,False,1271,Michigan State
11,School Totals,200,26,45,.578,20,26,.769,6,19,.316,16,25,.640,5,21,26,16,10,2,15,20,74,False,1272,Michigan State
12,School Totals,200,26,49,.531,23,38,.605,3,11,.273,15,18,.833,10,31,41,15,6,4,20,16,70,False,1273,Michigan State
10,School Totals,200,20,47,.426,15,31,.484,5,16,.313,18,25,.720,10,23,33,12,9,7,20,17,63,False,1274,Michigan State
12,School Totals,200,24,59,.407,18,45,.400,6,14,.429,5,11,.455,12,21,33,11,4,3,11,16,59,False,1275,Michigan State
14,School Totals,200,33,55,.600,28,45,.622,5,10,.500,13,23,.565,9,31,40,20,11,7,8,12,84,False,1276,Michigan State
14,School Totals,200,28,56,.500,21,31,.677,7,25,.280,13,20,.650,18,24,42,21,14,5,18,19,76,False,1277,Michigan State
12,School Totals,200,22,45,.489,15,29,.517,7,16,.438,22,28,.786,8,24,32,14,4,5,12,16,73,False,1278,Michigan State
14,School Totals,200,30,67,.448,25,49,.510,5,18,.278,27,32,.844,16,44,60,19,9,4,22,13,92,False,1279,Michigan State
10,School Totals,200,26,54,.481,23,45,.511,3,9,.333,9,12,.750,8,28,36,10,6,5,14,19,64,False,1280,Michigan State
12,School Totals,200,21,47,.447,19,36,.528,2,11,.182,23,30,.767,7,25,32,13,10,2,16,20,67,False,1281,Michigan State
10,School Totals,200,28,63,.444,23,52,.442,5,11,.455,2,10,.200,10,14,24,18,10,3,13,21,63,False,1282,Michigan State
13,School Totals,200,29,64,.453,21,49,.429,8,15,.533,18,22,.818,11,30,41,21,8,3,12,20,84,False,1283,Michigan State
10,School Totals,200,23,57,.404,20,46,.435,3,11,.273,13,21,.619,9,24,33,13,12,3,12,17,62,False,1284,Michigan State
10,School Totals,200,22,48,.458,18,35,.514,4,13,.308,18,28,.643,7,26,33,14,8,5,11,8,66,False,1285,Michigan State
11,School Totals,200,26,55,.473,19,38,.500,7,17,.412,22,30,.733,7,22,29,17,5,3,7,18,81,False,1286,Michigan State
9,School Totals,200,22,50,.440,19,37,.514,3,13,.231,12,14,.857,7,22,29,7,9,0,13,14,59,False,1287,Michigan State
11,School Totals,200,18,47,.383,14,38,.368,4,9,.444,9,12,.750,7,25,32,7,6,3,10,15,49,False,1288,Michigan State
10,School Totals,200,27,60,.450,16,37,.432,11,23,.478,5,6,.833,11,19,30,16,11,1,18,18,70,False,118,Michigan State
11,School Totals,200,25,42,.595,19,28,.679,6,14,.429,24,34,.706,7,22,29,15,4,3,14,15,80,False,1289,Michigan State
10,School Totals,200,20,46,.435,11,28,.393,9,18,.500,12,20,.600,5,22,27,12,9,3,5,14,61,False,1290,Michigan State
13,School Totals,200,27,55,.491,23,43,.535,4,12,.333,20,24,.833,8,18,26,9,13,1,9,24,78,False,1291,Michigan State
14,School Totals,200,30,62,.484,23,42,.548,7,20,.350,8,17,.471,14,26,40,18,9,3,8,14,75,False,902,Michigan State
10,School Totals,200,23,45,.511,19,32,.594,4,13,.308,23,29,.793,11,30,41,8,3,12,13,13,73,False,1292,Michigan State
10,School Totals,200,24,56,.429,20,41,.488,4,15,.267,16,23,.696,10,21,31,12,7,7,11,15,68,False,125,Michigan State
10,School Totals,200,21,46,.457,19,35,.543,2,11,.182,16,22,.727,8,23,31,12,6,1,14,18,60,False,1293,Michigan State
10,School Totals,200,21,59,.356,15,37,.405,6,22,.273,9,12,.750,17,24,41,9,3,2,18,15,57,False,906,Michigan State
16,School Totals,200,24,65,.369,21,50,.420,3,15,.200,7,9,.778,14,25,39,12,16,1,10,16,58,False,1294,Michigan State
11,School Totals,200,25,38,.658,19,28,.679,6,10,.600,15,20,.750,4,18,22,17,4,2,12,9,71,False,1295,Michigan State
10,School Totals,200,22,57,.386,19,42,.452,3,15,.200,12,16,.750,14,14,28,9,9,5,13,13,59,False,1296,Michigan State
10,School Totals,200,20,50,.400,14,36,.389,6,14,.429,12,15,.800,10,25,35,10,3,5,12,14,58,False,1297,Michigan State
13,School Totals,199,26,58,.448,20,43,.465,6,15,.400,7,11,.636,17,27,44,16,6,3,17,16,65,False,1298,Michigan State
14,School Totals,200,26,52,.500,22,36,.611,4,16,.250,14,22,.636,10,31,41,14,10,7,18,14,70,False,1299,Michigan State
10,School Totals,200,20,50,.400,17,38,.447,3,12,.250,18,24,.750,8,25,33,6,6,4,10,24,61,False,1300,Michigan State
16,School Totals,200,42,81,.519,32,55,.582,10,26,.385,4,5,.800,16,48,64,32,4,4,15,12,98,False,1301,Michigan State
10,School Totals,200,30,63,.476,25,51,.490,5,12,.417,13,17,.765,7,21,28,17,13,3,7,27,78,False,1302,Michigan State
11,School Totals,200,20,44,.455,20,37,.541,0,7,.000,22,30,.733,5,22,27,16,5,4,11,14,62,False,1303,Michigan State
12,School Totals,200,29,67,.433,16,37,.432,13,30,.433,11,13,.846,12,23,35,21,7,2,10,15,82,False,1304,Michigan State
16,School Totals,200,36,71,.507,22,36,.611,14,35,.400,10,13,.769,9,24,33,26,13,6,6,16,96,False,1305,Michigan State
11,School Totals,200,29,58,.500,23,39,.590,6,19,.316,23,36,.639,8,31,39,14,4,6,13,23,87,False,1306,Michigan State
16,School Totals,200,41,65,.631,32,47,.681,9,18,.500,7,9,.778,4,35,39,28,6,3,9,9,98,False,1307,Michigan State
12,School Totals,200,23,64,.359,16,40,.400,7,24,.292,12,18,.667,12,24,36,12,6,7,14,19,65,False,1308,Michigan State
10,School Totals,200,24,57,.421,18,41,.439,6,16,.375,13,19,.684,12,25,37,14,11,5,17,14,67,False,1309,Michigan State
13,School Totals,200,27,51,.529,23,39,.590,4,12,.333,20,38,.526,9,27,36,15,10,3,10,19,78,False,1310,Michigan State
11,School Totals,200,29,58,.500,22,36,.611,7,22,.318,27,33,.818,11,30,41,14,4,3,13,25,92,False,1311,Michigan State
15,School Totals,200,36,66,.545,23,41,.561,13,25,.520,16,24,.667,18,32,50,25,9,6,10,15,101,False,1312,Michigan State
11,School Totals,200,29,66,.439,19,46,.413,10,20,.500,11,13,.846,12,28,40,16,5,6,11,17,79,False,1313,Michigan State
13,School Totals,200,28,59,.475,18,35,.514,10,24,.417,7,11,.636,9,23,32,14,12,9,11,21,73,False,149,Michigan State
11,School Totals,225,26,57,.456,15,38,.395,11,19,.579,9,14,.643,7,21,28,16,9,5,15,18,72,False,1314,Michigan State
11,School Totals,225,24,59,.407,17,38,.447,7,21,.333,32,40,.800,12,29,41,16,10,10,7,17,87,False,1315,Michigan State
11,School Totals,200,20,52,.385,18,36,.500,2,16,.125,12,20,.600,12,25,37,13,7,5,6,16,54,False,1316,Michigan State
11,School Totals,200,29,52,.558,23,37,.622,6,15,.400,14,22,.636,8,29,37,15,5,7,12,16,78,False,1317,Michigan State
12,School Totals,200,23,51,.451,17,33,.515,6,18,.333,19,28,.679,7,18,25,14,12,6,13,22,71,False,153,Michigan State
12,School Totals,200,26,56,.464,19,39,.487,7,17,.412,16,23,.696,10,18,28,18,8,5,5,22,75,False,934,Michigan State
11,School Totals,225,25,59,.424,15,30,.500,10,29,.345,11,20,.550,10,26,36,12,5,5,9,29,71,False,1318,Michigan State
11,School Totals,200,21,53,.396,12,24,.500,9,29,.310,9,16,.563,9,15,24,13,7,4,15,21,60,False,1319,Michigan State
15,School Totals,200,28,60,.467,16,37,.432,12,23,.522,14,18,.778,12,27,39,22,7,6,10,22,82,False,1320,Michigan State
11,School Totals,200,24,60,.400,19,41,.463,5,19,.263,5,9,.556,8,21,29,9,6,2,11,17,58,False,1321,Michigan State
15,School Totals,200,32,60,.533,21,39,.538,11,21,.524,10,14,.714,13,24,37,22,5,1,5,18,85,False,1322,Michigan State
12,School Totals,199,17,50,.340,12,26,.462,5,24,.208,12,14,.857,8,29,37,12,2,2,11,19,51,False,1323,Michigan State
16,School Totals,200,30,52,.577,13,20,.650,17,32,.531,17,22,.773,6,20,26,26,8,5,11,29,94,False,1324,Michigan State
11,School Totals,200,26,48,.542,17,25,.680,9,23,.391,9,15,.600,7,21,28,13,1,2,13,23,70,False,940,Michigan State
11,School Totals,200,18,46,.391,12,28,.429,6,18,.333,4,11,.364,12,21,33,12,8,3,16,13,46,False,1325,Michigan State
16,School Totals,200,28,48,.583,18,31,.581,10,17,.588,20,26,.769,6,20,26,20,9,7,15,20,86,False,1326,Michigan State
12,School Totals,200,24,55,.436,14,35,.400,10,20,.500,9,10,.900,8,20,28,17,1,4,15,22,67,False,1327,Michigan State
16,School Totals,200,27,60,.450,19,41,.463,8,19,.421,5,10,.500,16,23,39,15,4,8,10,11,67,False,1328,Michigan State
11,School Totals,200,29,51,.569,22,38,.579,7,13,.538,18,28,.643,9,18,27,15,6,4,8,22,83,False,1329,Michigan State
16,School Totals,200,27,54,.500,25,37,.676,2,17,.118,13,16,.813,13,24,37,14,7,6,10,19,69,False,946,Michigan State
16,School Totals,200,30,56,.536,20,37,.541,10,19,.526,23,25,.920,9,29,38,16,4,2,14,27,93,False,1330,Michigan State
11,School Totals,200,28,57,.491,21,36,.583,7,21,.333,17,22,.773,9,21,30,17,9,1,11,20,80,False,1331,Michigan State
12,School Totals,200,21,47,.447,16,33,.485,5,14,.357,14,18,.778,6,23,29,13,5,4,9,16,61,False,1332,Michigan State
10,School Totals,200,18,46,.391,7,17,.412,11,29,.379,7,8,.875,4,24,28,13,5,3,16,16,54,False,1333,Michigan State
11,School Totals,200,25,53,.472,17,34,.500,8,19,.421,6,10,.600,8,28,36,18,6,4,14,13,64,False,1334,Michigan State
10,School Totals,200,30,60,.500,25,40,.625,5,20,.250,6,10,.600,12,21,33,15,2,0,13,22,71,False,1335,Michigan State
12,School Totals,200,36,57,.632,27,39,.692,9,18,.500,6,13,.462,7,31,38,27,6,5,14,13,87,False,1336,Michigan State
11,School Totals,200,29,66,.439,17,36,.472,12,30,.400,9,17,.529,19,31,50,22,4,10,12,15,79,False,1337,Michigan State
12,School Totals,200,27,55,.491,15,30,.500,12,25,.480,11,15,.733,9,32,41,16,4,3,14,20,77,False,1338,Michigan State
10,School Totals,200,26,45,.578,14,22,.636,12,23,.522,15,18,.833,3,22,25,14,7,6,16,18,79,False,1339,Michigan State
11,School Totals,200,19,59,.322,13,42,.310,6,17,.353,12,17,.706,9,26,35,5,5,4,7,22,56,False,1340,Michigan State
11,School Totals,225,32,65,.492,23,48,.479,9,17,.529,5,9,.556,15,23,38,16,2,5,12,22,78,False,1341,Michigan State
13,School Totals,200,30,50,.600,20,32,.625,10,18,.556,15,27,.556,10,29,39,27,8,5,18,14,85,False,1342,Michigan State
13,School Totals,200,34,61,.557,24,44,.545,10,17,.588,9,19,.474,9,28,37,25,10,1,8,18,87,False,1343,Michigan State
13,School Totals,200,20,53,.377,13,32,.406,7,21,.333,19,25,.760,11,33,44,17,4,5,12,19,66,False,1344,Michigan State
11,School Totals,225,24,61,.393,20,40,.500,4,21,.190,12,21,.571,17,21,38,13,5,3,13,22,64,False,1345,Michigan State
12,School Totals,200,32,53,.604,28,42,.667,4,11,.364,14,19,.737,8,24,32,23,8,2,10,15,82,False,1346,Michigan State
11,School Totals,250,21,65,.323,16,43,.372,5,22,.227,19,28,.679,8,27,35,15,11,5,12,27,66,False,575,Michigan State
14,School Totals,200,28,60,.467,23,45,.511,5,15,.333,9,16,.563,15,31,46,21,5,7,11,15,70,False,181,Michigan State
12,School Totals,200,27,53,.509,15,36,.417,12,17,.706,9,12,.750,7,25,32,19,5,3,10,21,75,False,1347,Michigan State
11,School Totals,225,31,62,.500,28,51,.549,3,11,.273,19,26,.731,11,19,30,18,6,1,7,14,84,False,1348,Michigan State
14,School Totals,200,26,58,.448,23,41,.561,3,17,.176,4,13,.308,13,20,33,13,4,8,12,21,59,False,580,Michigan State
11,School Totals,200,23,54,.426,19,41,.463,4,13,.308,16,25,.640,15,23,38,16,5,5,13,20,66,False,1349,Michigan State
12,School Totals,200,27,66,.409,19,43,.442,8,23,.348,15,25,.600,21,24,45,12,8,0,14,27,77,False,1350,Michigan State
13,School Totals,200,27,53,.509,19,33,.576,8,20,.400,9,14,.643,7,34,41,14,6,7,17,18,71,False,1351,Michigan State
10,School Totals,225,27,58,.466,19,36,.528,8,22,.364,14,22,.636,12,29,41,19,10,7,12,13,76,False,972,Michigan State
10,School Totals,200,20,52,.385,13,32,.406,7,20,.350,7,18,.389,8,24,32,13,4,4,9,14,54,False,1352,Michigan State
13,School Totals,200,23,50,.460,10,25,.400,13,25,.520,9,13,.692,10,19,29,19,6,7,11,13,68,False,1353,Michigan State
10,School Totals,200,24,50,.480,17,35,.486,7,15,.467,4,7,.571,5,23,28,19,4,8,10,14,59,False,1354,Michigan State
13,School Totals,200,31,50,.620,25,32,.781,6,18,.333,12,17,.706,9,23,32,17,1,3,8,18,80,False,975,Michigan State
11,School Totals,200,20,47,.426,17,32,.531,3,15,.200,17,20,.850,4,28,32,8,2,3,10,24,60,False,1355,Michigan State
10,School Totals,225,29,63,.460,16,31,.516,13,32,.406,19,29,.655,11,22,33,24,4,6,12,29,90,False,1356,Michigan State
11,School Totals,200,24,53,.453,15,36,.417,9,17,.529,4,9,.444,6,17,23,14,3,4,7,17,61,False,1357,Michigan State
12,School Totals,200,23,52,.442,14,29,.483,9,23,.391,17,29,.586,10,20,30,12,8,7,7,16,72,False,1358,Michigan State
11,School Totals,200,28,64,.438,21,36,.583,7,28,.250,11,20,.550,12,23,35,17,4,3,8,21,74,False,197,Michigan State
11,School Totals,200,29,61,.475,22,40,.550,7,21,.333,11,18,.611,10,24,34,23,6,8,7,20,76,False,1359,Michigan State
11,School Totals,200,22,50,.440,17,32,.531,5,18,.278,13,20,.650,12,16,28,15,5,4,11,18,62,False,591,Michigan State
11,School Totals,225,27,53,.509,21,39,.538,6,14,.429,9,9,1.000,6,23,29,16,3,2,13,17,69,False,1360,Michigan State
11,School Totals,200,26,57,.456,19,39,.487,7,18,.389,11,19,.579,5,28,33,18,8,3,9,22,70,False,1361,Michigan State
10,School Totals,200,17,40,.425,11,28,.393,6,12,.500,20,33,.606,7,23,30,7,4,7,6,19,60,False,1362,Michigan State
11,School Totals,200,22,57,.386,13,30,.433,9,27,.333,9,16,.563,14,20,34,9,1,1,5,16,62,False,1363,Michigan State
10,School Totals,225,26,60,.433,17,37,.459,9,23,.391,15,20,.750,7,28,35,20,5,7,10,22,76,False,1364,Michigan State
13,School Totals,200,22,55,.400,15,35,.429,7,20,.350,10,16,.625,8,23,31,10,4,3,14,28,61,False,1365,Michigan State
14,School Totals,200,30,62,.484,25,49,.510,5,13,.385,17,28,.607,17,33,50,25,1,12,13,14,82,False,1366,Michigan State
13,School Totals,200,28,60,.467,19,39,.487,9,21,.429,14,16,.875,9,28,37,20,1,8,15,25,79,False,1367,Michigan State
15,School Totals,200,33,57,.579,24,31,.774,9,26,.346,17,26,.654,17,27,44,26,11,5,13,13,92,False,1368,Michigan State
15,School Totals,200,31,64,.484,22,44,.500,9,20,.450,18,24,.750,15,40,55,26,2,8,13,22,89,False,1369,Michigan State
15,School Totals,200,37,59,.627,26,38,.684,11,21,.524,14,20,.700,7,27,34,28,3,3,7,16,99,False,1370,Michigan State
14,School Totals,200,25,55,.455,15,32,.469,10,23,.435,17,19,.895,5,27,32,23,3,3,10,23,77,False,1371,Michigan State
12,School Totals,200,26,55,.473,19,33,.576,7,22,.318,18,26,.692,8,23,31,18,6,0,8,18,77,False,1372,Michigan State
12,School Totals,200,23,54,.426,14,31,.452,9,23,.391,16,22,.727,15,23,38,17,7,8,17,14,71,False,1373,Michigan State
15,School Totals,200,30,64,.469,23,38,.605,7,26,.269,9,14,.643,12,41,53,24,5,5,9,15,76,False,1374,Michigan State
15,School Totals,200,27,54,.500,15,32,.469,12,22,.545,12,15,.800,9,36,45,25,5,10,15,9,78,False,1375,Michigan State
13,School Totals,200,21,57,.368,16,32,.500,5,25,.200,11,15,.733,15,27,42,18,6,6,12,18,58,False,1376,Michigan State
16,School Totals,200,33,59,.559,27,46,.587,6,13,.462,6,10,.600,6,24,30,21,8,4,12,21,78,False,1377,Michigan State
13,School Totals,225,30,60,.500,20,43,.465,10,17,.588,29,42,.690,10,28,38,17,1,3,14,31,99,False,1378,Michigan State
15,School Totals,200,27,64,.422,24,51,.471,3,13,.231,13,20,.650,17,21,38,11,7,5,15,27,70,False,1379,Michigan State
12,School Totals,200,24,49,.490,20,36,.556,4,13,.308,17,20,.850,9,32,41,16,0,7,10,21,69,False,1380,Michigan State
16,School Totals,200,33,62,.532,27,47,.574,6,15,.400,7,10,.700,10,36,46,26,3,8,11,17,79,False,1381,Michigan State
16,School Totals,200,35,70,.500,25,50,.500,10,20,.500,12,15,.800,9,27,36,17,7,1,6,25,92,False,1382,Michigan State
14,School Totals,200,23,55,.418,19,34,.559,4,21,.190,9,13,.692,6,27,33,14,3,4,16,19,59,False,1383,Michigan State
14,School Totals,200,28,59,.475,20,41,.488,8,18,.444,12,16,.750,13,17,30,11,3,1,9,28,76,False,1384,Michigan State
10,School Totals,200,24,57,.421,13,39,.333,11,18,.611,12,21,.571,11,24,35,19,2,4,10,15,71,False,1385,Michigan State
11,School Totals,200,22,61,.361,15,38,.395,7,23,.304,23,29,.793,16,28,44,17,6,5,8,17,74,False,613,Michigan State
15,School Totals,200,28,55,.509,12,29,.414,16,26,.615,4,4,1.000,7,33,40,22,5,8,13,21,76,False,1386,Michigan State
16,School Totals,200,33,70,.471,16,38,.421,17,32,.531,13,17,.765,17,37,54,28,5,7,11,15,96,False,1387,Michigan State
15,School Totals,200,32,50,.640,18,28,.643,14,22,.636,11,16,.688,7,28,35,18,4,1,19,20,89,False,1002,Michigan State
13,School Totals,225,29,76,.382,18,48,.375,11,28,.393,12,15,.800,15,22,37,24,5,5,8,26,81,False,1388,Michigan State
16,School Totals,200,34,59,.576,24,36,.667,10,23,.435,10,12,.833,6,29,35,27,4,10,11,17,88,False,226,Michigan State
15,School Totals,200,26,56,.464,18,39,.462,8,17,.471,9,13,.692,11,26,37,20,4,6,11,18,69,False,1389,Michigan State
15,School Totals,200,31,57,.544,17,35,.486,14,22,.636,5,7,.714,6,23,29,16,5,1,7,18,81,False,1390,Michigan State
15,School Totals,200,28,63,.444,18,41,.439,10,22,.455,22,33,.667,17,32,49,22,3,6,10,20,88,False,1391,Michigan State
15,School Totals,200,37,76,.487,21,45,.467,16,31,.516,7,12,.583,21,26,47,27,9,4,12,17,97,False,1392,Michigan State
15,School Totals,200,34,51,.667,26,35,.743,8,16,.500,15,20,.750,4,27,31,29,4,4,13,17,91,False,1393,Michigan State
15,School Totals,200,31,64,.484,23,41,.561,8,23,.348,11,14,.786,13,26,39,17,10,4,8,15,81,False,1394,Michigan State
11,School Totals,200,21,50,.420,13,31,.419,8,19,.421,14,15,.933,4,24,28,15,1,4,11,18,64,False,625,Michigan State
13,School Totals,200,25,60,.417,17,39,.436,8,21,.381,8,9,.889,11,29,40,15,1,5,9,19,66,False,1395,Michigan State
16,School Totals,200,30,54,.556,19,30,.633,11,24,.458,10,15,.667,8,22,30,20,6,2,14,22,81,False,1396,Michigan State
12,School Totals,200,25,58,.431,17,33,.515,8,25,.320,5,9,.556,10,18,28,15,4,1,17,23,63,False,1397,Michigan State
12,School Totals,200,20,61,.328,15,35,.429,5,26,.192,3,9,.333,12,29,41,9,0,4,19,20,48,False,1398,Michigan State
14,School Totals,200,39,59,.661,23,31,.742,16,28,.571,6,10,.600,12,30,42,33,6,4,14,15,100,False,1399,Michigan State
12,School Totals,200,25,49,.510,16,32,.500,9,17,.529,19,33,.576,6,23,29,21,3,8,12,18,78,False,1400,Michigan State
12,School Totals,200,25,58,.431,16,34,.471,9,24,.375,14,22,.636,6,40,46,16,1,4,13,19,73,False,1401,Michigan State
12,School Totals,200,22,51,.431,15,28,.536,7,23,.304,7,9,.778,3,24,27,17,3,6,12,14,58,False,1402,Michigan State
12,School Totals,200,26,52,.500,15,27,.556,11,25,.440,14,21,.667,7,27,34,20,2,6,14,25,77,False,1403,Michigan State
11,School Totals,200,27,55,.491,22,39,.564,5,16,.313,10,14,.714,8,30,38,16,3,1,17,20,69,False,1404,Michigan State
11,School Totals,200,24,54,.444,17,34,.500,7,20,.350,25,34,.735,11,25,36,19,4,8,10,19,80,False,1405,Michigan State
13,School Totals,200,34,67,.507,26,42,.619,8,25,.320,1,6,.167,14,33,47,28,7,8,12,15,77,False,1406,Michigan State
10,School Totals,200,22,47,.468,12,22,.545,10,25,.400,17,30,.567,8,25,33,19,3,6,12,22,71,False,1407,Michigan State
13,School Totals,200,26,54,.481,21,38,.553,5,16,.313,16,26,.615,8,22,30,17,7,7,14,21,73,False,1408,Michigan State
11,School Totals,200,23,48,.479,16,32,.500,7,16,.438,24,37,.649,12,24,36,15,11,7,17,25,77,False,1409,Michigan State
11,School Totals,225,30,66,.455,25,48,.521,5,18,.278,10,22,.455,7,28,35,17,9,7,11,31,75,False,1410,Michigan State
11,School Totals,200,21,49,.429,17,32,.531,4,17,.235,15,22,.682,10,30,40,14,5,4,12,18,61,False,1411,Michigan State
14,School Totals,200,33,57,.579,22,35,.629,11,22,.500,16,22,.727,7,26,33,26,6,10,10,22,93,False,1412,Michigan State
12,School Totals,200,23,56,.411,16,33,.485,7,23,.304,10,14,.714,2,23,25,11,7,6,17,26,63,False,1413,Michigan State
14,School Totals,200,23,54,.426,18,40,.450,5,14,.357,14,17,.824,9,29,38,15,6,7,13,14,65,False,1414,Michigan State
12,School Totals,200,25,50,.500,16,31,.516,9,19,.474,8,14,.571,5,23,28,17,3,1,15,19,67,False,1415,Michigan State
11,School Totals,200,24,54,.444,16,36,.444,8,18,.444,19,25,.760,12,18,30,11,2,2,12,20,75,False,255,Michigan State
11,School Totals,200,27,52,.519,16,28,.571,11,24,.458,8,14,.571,4,19,23,20,6,6,13,22,73,False,1416,Michigan State
12,School Totals,200,24,46,.522,19,35,.543,5,11,.455,17,23,.739,8,22,30,13,8,4,11,18,70,False,1032,Michigan State
12,School Totals,200,29,52,.558,18,35,.514,11,17,.647,3,6,.500,5,21,26,14,4,4,14,22,72,False,1417,Michigan State
13,School Totals,200,23,48,.479,18,32,.563,5,16,.313,6,9,.667,6,18,24,10,3,0,17,19,57,False,1034,Michigan State
12,School Totals,200,29,60,.483,20,34,.588,9,26,.346,10,14,.714,13,31,44,24,5,5,18,19,77,False,1418,Michigan State
12,School Totals,200,25,52,.481,15,27,.556,10,25,.400,14,21,.667,8,28,36,20,5,4,15,19,74,False,1419,Michigan State
14,School Totals,200,25,59,.424,16,32,.500,9,27,.333,4,10,.400,8,24,32,16,4,2,15,23,63,False,1420,Michigan State
12,School Totals,200,29,62,.468,25,47,.532,4,15,.267,26,35,.743,11,29,40,18,7,6,9,21,88,False,1421,Michigan State
10,School Totals,200,28,60,.467,21,43,.488,7,17,.412,21,23,.913,10,31,41,18,2,1,11,22,84,False,1422,Michigan State
10,School Totals,200,25,52,.481,17,31,.548,8,21,.381,12,15,.800,6,26,32,9,1,4,15,17,70,False,1423,Michigan State
11,School Totals,200,22,60,.367,14,39,.359,8,21,.381,8,11,.727,11,25,36,13,2,4,7,19,60,False,658,Michigan State
13,School Totals,200,28,57,.491,18,35,.514,10,22,.455,12,18,.667,10,33,43,19,4,8,11,21,78,False,1424,Michigan State
10,School Totals,200,19,58,.328,13,28,.464,6,30,.200,14,20,.700,17,20,37,10,4,3,11,19,58,False,1425,Michigan State
13,School Totals,200,30,53,.566,24,33,.727,6,20,.300,12,14,.857,9,25,34,18,1,3,12,18,78,False,1426,Michigan State
11,School Totals,200,25,57,.439,17,34,.500,8,23,.348,12,17,.706,4,20,24,13,3,1,10,14,70,False,1427,Michigan State
13,School Totals,200,35,61,.574,32,49,.653,3,12,.250,25,32,.781,13,32,45,22,12,10,21,21,98,False,1428,Michigan State
12,School Totals,200,31,61,.508,22,36,.611,9,25,.360,10,18,.556,8,22,30,25,1,12,17,21,81,False,1429,Michigan State
12,School Totals,200,33,57,.579,28,42,.667,5,15,.333,22,27,.815,11,29,40,20,5,7,14,20,93,False,1430,Michigan State
11,School Totals,200,25,53,.472,15,30,.500,10,23,.435,13,17,.765,8,29,37,17,5,1,14,26,73,False,1431,Michigan State
11,School Totals,200,32,66,.485,24,48,.500,8,18,.444,5,10,.500,11,27,38,12,3,4,8,16,77,False,1432,Michigan State
12,School Totals,200,22,55,.400,12,29,.414,10,26,.385,9,13,.692,10,34,44,16,7,7,22,23,63,False,1433,Michigan State
12,School Totals,200,31,60,.517,22,39,.564,9,21,.429,10,14,.714,13,26,39,21,4,6,13,14,81,False,1434,Michigan State
13,School Totals,200,27,57,.474,22,38,.579,5,19,.263,27,36,.750,11,34,45,16,1,11,6,16,86,False,1435,Michigan State
12,School Totals,200,22,57,.386,14,36,.389,8,21,.381,10,16,.625,12,28,40,15,4,13,14,17,62,False,1436,Michigan State
13,School Totals,200,28,59,.475,19,40,.475,9,19,.474,23,31,.742,14,34,48,24,6,12,11,12,88,False,1437,Michigan State
13,School Totals,200,31,60,.517,22,37,.595,9,23,.391,15,23,.652,14,29,43,18,7,6,17,16,86,False,1438,Michigan State
13,School Totals,200,36,56,.643,26,36,.722,10,20,.500,25,33,.758,10,32,42,30,4,16,14,22,107,False,1439,Michigan State
13,School Totals,200,39,64,.609,26,35,.743,13,29,.448,11,13,.846,12,23,35,28,9,10,11,15,102,False,1440,Michigan State
12,School Totals,200,41,63,.651,26,37,.703,15,26,.577,14,18,.778,15,32,47,29,1,4,11,18,111,False,1441,Michigan State
12,School Totals,200,44,70,.629,36,48,.750,8,22,.364,12,22,.545,14,43,57,35,6,7,17,14,108,False,1442,Michigan State
13,School Totals,200,32,56,.571,16,28,.571,16,28,.571,11,15,.733,7,26,33,30,4,9,7,17,91,False,677,Michigan State
11,School Totals,200,23,59,.390,16,34,.471,7,25,.280,11,13,.846,9,24,33,13,3,1,11,17,64,False,1443,Michigan State
11,School Totals,225,21,51,.412,12,32,.375,9,19,.474,25,34,.735,7,29,36,19,3,8,13,19,76,False,1444,Michigan State
11,School Totals,200,21,46,.457,18,33,.545,3,13,.231,27,32,.844,8,24,32,13,3,8,17,26,72,False,1065,Michigan State
13,School Totals,200,32,59,.542,22,39,.564,10,20,.500,11,17,.647,11,33,44,23,2,7,13,14,85,False,288,Michigan State
11,School Totals,200,30,44,.682,26,35,.743,4,9,.444,23,28,.821,9,28,37,15,5,9,25,18,87,False,1445,Michigan State
13,School Totals,200,27,54,.500,19,35,.543,8,19,.421,14,16,.875,9,25,34,19,2,9,12,19,76,False,1446,Michigan State
11,School Totals,200,25,63,.397,20,42,.476,5,21,.238,19,23,.826,16,24,40,11,6,7,9,19,74,False,682,Michigan State
11,School Totals,200,24,48,.500,16,31,.516,8,17,.471,20,25,.800,4,34,38,18,5,7,15,14,76,False,1447,Michigan State
12,School Totals,200,23,47,.489,14,29,.483,9,18,.500,8,17,.471,3,23,26,15,3,13,11,24,63,False,293,Michigan State
11,School Totals,200,32,57,.561,24,40,.600,8,17,.471,24,29,.828,6,25,31,20,3,4,10,19,96,False,1448,Michigan State
12,School Totals,200,29,60,.483,23,42,.548,6,18,.333,4,6,.667,6,31,37,21,2,4,6,14,68,False,1449,Michigan State
13,School Totals,200,32,60,.533,18,38,.474,14,22,.636,9,14,.643,12,34,46,27,3,4,13,14,87,False,1450,Michigan State
12,School Totals,200,20,46,.435,12,28,.429,8,18,.444,17,21,.810,6,25,31,16,3,0,11,16,65,False,1451,Michigan State
13,School Totals,200,24,51,.471,13,24,.542,11,27,.407,22,26,.846,7,33,40,20,2,11,8,20,81,False,1452,Michigan State
11,School Totals,200,23,53,.434,15,33,.455,8,20,.400,14,18,.778,13,25,38,10,4,8,12,18,68,False,1453,Michigan State
11,School Totals,200,24,56,.429,19,40,.475,5,16,.313,10,11,.909,11,25,36,10,3,7,10,14,63,False,1454,Michigan State
11,School Totals,200,24,63,.381,17,38,.447,7,25,.280,9,10,.900,9,23,32,10,4,1,8,23,64,False,1078,Michigan State
12,School Totals,200,31,58,.534,26,41,.634,5,17,.294,15,22,.682,10,26,36,21,4,6,9,22,82,False,1455,Michigan State
11,School Totals,200,17,66,.258,9,29,.310,8,37,.216,11,16,.688,26,18,44,11,4,2,14,22,53,False,1456,Michigan State
12,School Totals,202,26,59,.441,14,36,.389,12,23,.522,23,35,.657,5,32,37,19,5,7,18,25,87,False,1457,Michigan State
15,School Totals,200,41,77,.532,33,54,.611,8,23,.348,16,23,.696,19,29,48,33,10,6,15,22,106,False,1458,Michigan State
16,School Totals,200,28,70,.400,22,41,.537,6,29,.207,18,22,.818,15,33,48,13,7,7,7,18,80,False,1459,Michigan State
16,School Totals,200,37,67,.552,23,34,.676,14,33,.424,13,18,.722,11,27,38,25,8,5,8,12,101,False,1460,Michigan State
13,School Totals,200,32,62,.516,19,38,.500,13,24,.542,10,18,.556,8,28,36,20,1,5,12,23,87,False,1461,Michigan State
12,School Totals,200,26,51,.510,14,31,.452,12,20,.600,14,18,.778,10,27,37,17,4,3,22,18,78,False,1462,Michigan State
12,School Totals,225,28,59,.475,20,39,.513,8,20,.400,14,23,.609,9,36,45,14,5,3,16,29,78,False,1463,Michigan State
10,School Totals,200,27,58,.466,22,42,.524,5,16,.313,19,25,.760,12,25,37,11,5,3,7,16,78,False,1464,Michigan State
15,School Totals,200,31,60,.517,28,48,.583,3,12,.250,25,32,.781,13,26,39,28,7,6,8,25,90,False,1465,Michigan State
9,School Totals,200,26,51,.510,22,36,.611,4,15,.267,7,8,.875,8,24,32,14,5,3,13,11,63,False,1466,Michigan State
17,School Totals,200,38,75,.507,27,47,.574,11,28,.393,17,26,.654,14,39,53,31,7,12,14,20,104,False,1467,Michigan State
17,School Totals,200,38,65,.585,25,35,.714,13,30,.433,10,12,.833,7,30,37,27,7,6,7,14,99,False,1468,Michigan State
17,School Totals,200,29,57,.509,15,28,.536,14,29,.483,16,23,.696,8,35,43,25,2,7,14,13,88,False,1469,Michigan State
16,School Totals,200,34,58,.586,29,46,.630,5,12,.417,8,15,.533,8,38,46,28,4,7,13,18,81,False,1470,Michigan State
10,School Totals,200,25,46,.543,19,28,.679,6,18,.333,30,37,.811,6,30,36,14,4,4,12,20,86,False,1471,Michigan State
13,School Totals,200,26,58,.448,17,31,.548,9,27,.333,16,19,.842,14,26,40,20,5,7,13,22,77,False,1472,Michigan State
11,School Totals,200,25,51,.490,17,31,.548,8,20,.400,13,19,.684,9,27,36,19,5,5,17,15,71,False,1473,Michigan State
11,School Totals,200,24,55,.436,18,35,.514,6,20,.300,16,18,.889,10,32,42,13,5,4,14,19,70,False,1474,Michigan State
12,School Totals,200,28,61,.459,22,35,.629,6,26,.231,7,11,.636,11,25,36,21,9,9,8,12,69,False,710,Michigan State
15,School Totals,200,27,51,.529,19,32,.594,8,19,.421,20,21,.952,11,30,41,16,3,2,16,13,82,False,1475,Michigan State
10,School Totals,200,22,56,.393,13,30,.433,9,26,.346,10,15,.667,9,23,32,12,8,9,12,16,63,False,1476,Michigan State
10,School Totals,225,29,64,.453,20,43,.465,9,21,.429,8,22,.364,12,23,35,23,7,14,10,19,75,False,322,Michigan State
10,School Totals,200,22,43,.512,15,24,.625,7,19,.368,23,25,.920,7,21,28,15,6,1,24,18,74,False,1477,Michigan State
16,School Totals,200,31,60,.517,25,45,.556,6,15,.400,11,16,.688,10,27,37,27,6,2,8,18,79,False,1478,Michigan State
9,School Totals,200,25,57,.439,16,35,.457,9,22,.409,8,11,.727,8,30,38,11,5,7,13,12,67,False,1479,Michigan State
14,School Totals,200,21,55,.382,11,29,.379,10,26,.385,10,12,.833,7,30,37,17,7,8,10,15,62,False,1480,Michigan State
11,School Totals,200,22,55,.400,15,35,.429,7,20,.350,20,22,.909,14,28,42,14,4,1,14,14,71,False,1481,Michigan State
9,School Totals,200,24,48,.500,19,28,.679,5,20,.250,24,30,.800,7,24,31,15,5,3,6,16,77,False,1110,Michigan State
9,School Totals,200,26,48,.542,20,33,.606,6,15,.400,4,5,.800,5,25,30,16,2,5,14,11,62,False,329,Michigan State
14,School Totals,200,32,60,.533,20,36,.556,12,24,.500,15,17,.882,10,28,38,22,3,4,10,17,91,False,1482,Michigan State
11,School Totals,200,23,49,.469,17,27,.630,6,22,.273,23,30,.767,10,32,42,12,3,8,13,12,75,False,1112,Michigan State
12,School Totals,200,26,50,.520,19,33,.576,7,17,.412,18,21,.857,5,19,24,20,8,3,11,16,77,False,1483,Michigan State
11,School Totals,200,23,53,.434,14,32,.438,9,21,.429,12,15,.800,6,36,42,18,4,4,14,16,67,False,1484,Michigan State
10,School Totals,200,22,55,.400,13,32,.406,9,23,.391,12,16,.750,9,24,33,14,2,6,9,10,65,False,1115,Michigan State
13,School Totals,200,23,54,.426,18,35,.514,5,19,.263,25,26,.962,8,28,36,9,3,5,9,18,76,False,1485,Michigan State
13,School Totals,200,28,49,.571,22,34,.647,6,15,.400,8,11,.727,10,30,40,16,4,3,20,18,70,False,1486,Michigan State
9,School Totals,200,31,66,.470,18,34,.529,13,32,.406,5,8,.625,12,24,36,22,4,6,6,10,80,False,1487,Michigan State
8,School Totals,200,30,70,.429,24,51,.471,6,19,.316,2,6,.333,11,19,30,18,11,3,6,11,68,False,1488,Michigan State
10,School Totals,200,15,47,.319,8,23,.348,7,24,.292,14,18,.778,7,25,32,6,1,2,10,15,51,False,1489,Michigan State
13,School Totals,200,22,56,.393,17,30,.567,5,26,.192,13,18,.722,7,23,30,14,4,2,15,22,62,False,1490,Michigan State
17,School Totals,200,38,74,.514,31,49,.633,7,25,.280,17,20,.850,11,26,37,25,7,7,4,13,100,False,1491,Michigan State
12,School Totals,200,27,65,.415,15,38,.395,12,27,.444,10,17,.588,12,25,37,15,11,3,14,14,76,False,1492,Michigan State
16,School Totals,200,36,64,.563,32,47,.681,4,17,.235,18,25,.720,15,39,54,31,6,8,12,13,94,False,1493,Michigan State
12,School Totals,200,24,59,.407,16,36,.444,8,23,.348,10,14,.714,13,26,39,13,3,2,16,20,66,False,1494,Michigan State
12,School Totals,200,32,63,.508,24,46,.522,8,17,.471,21,27,.778,7,27,34,20,6,2,12,15,93,False,1495,Michigan State
17,School Totals,200,23,50,.460,15,31,.484,8,19,.421,21,25,.840,9,21,30,11,3,9,6,19,75,False,1496,Michigan State
13,School Totals,200,28,62,.452,24,46,.522,4,16,.250,15,23,.652,10,21,31,21,7,6,14,15,75,False,1497,Michigan State
10,School Totals,200,24,55,.436,17,34,.500,7,21,.333,22,27,.815,5,28,33,17,8,3,11,16,77,False,1498,Michigan State
16,School Totals,200,26,58,.448,19,25,.760,7,33,.212,13,18,.722,10,39,49,21,2,5,17,14,72,False,1499,Michigan State
11,School Totals,200,28,61,.459,19,40,.475,9,21,.429,12,14,.857,9,32,41,17,3,3,16,12,77,False,1500,Michigan State
16,School Totals,200,32,59,.542,17,29,.586,15,30,.500,22,31,.710,10,40,50,27,5,9,16,25,101,False,1501,Michigan State
15,School Totals,200,32,65,.492,22,38,.579,10,27,.370,21,26,.808,16,29,45,28,3,3,8,12,95,False,1502,Michigan State
17,School Totals,200,26,60,.433,19,38,.500,7,22,.318,17,24,.708,10,36,46,20,2,9,10,19,76,False,1503,Michigan State
13,School Totals,200,28,53,.528,21,38,.553,7,15,.467,24,33,.727,8,33,41,16,3,12,13,18,87,False,1132,Michigan State
11,School Totals,200,28,65,.431,22,45,.489,6,20,.300,12,16,.750,17,28,45,20,8,6,12,12,74,False,1504,Michigan State
15,School Totals,200,18,51,.353,16,35,.457,2,16,.125,4,6,.667,10,20,30,7,4,6,18,17,42,False,1505,Michigan State
11,School Totals,200,27,58,.466,21,42,.500,6,16,.375,7,10,.700,9,30,39,20,4,2,11,13,67,False,1506,Michigan State
11,School Totals,200,22,49,.449,13,28,.464,9,21,.429,10,14,.714,5,24,29,13,4,6,11,17,63,False,354,Michigan State
14,School Totals,200,26,55,.473,19,38,.500,7,17,.412,11,13,.846,7,29,36,18,6,3,9,19,70,False,1507,Michigan State
15,School Totals,200,27,63,.429,15,33,.455,12,30,.400,13,14,.929,11,23,34,21,9,7,11,13,79,False,1508,Michigan State
12,School Totals,200,25,63,.397,15,38,.395,10,25,.400,3,4,.750,7,28,35,14,5,3,12,16,63,False,1509,Michigan State
11,School Totals,200,26,55,.473,19,32,.594,7,23,.304,11,13,.846,7,29,36,16,5,9,15,20,70,False,1510,Michigan State
11,School Totals,200,21,63,.333,15,40,.375,6,23,.261,20,24,.833,11,28,39,10,7,4,7,18,68,False,1141,Michigan State
12,School Totals,200,28,57,.491,21,39,.538,7,18,.389,7,14,.500,5,24,29,10,7,3,16,24,70,False,1511,Michigan State
12,School Totals,200,23,55,.418,19,36,.528,4,19,.211,10,14,.714,7,26,33,13,4,4,8,15,60,False,747,Michigan State
15,School Totals,200,32,62,.516,19,35,.543,13,27,.481,9,14,.643,13,34,47,20,5,2,20,15,86,False,1512,Michigan State
12,School Totals,200,27,54,.500,20,34,.588,7,20,.350,17,23,.739,6,25,31,19,6,4,11,18,78,False,1513,Michigan State
12,School Totals,200,28,59,.475,16,31,.516,12,28,.429,10,12,.833,10,25,35,20,4,3,11,23,78,False,751,Michigan State
11,School Totals,200,32,60,.533,27,41,.659,5,19,.263,10,14,.714,10,30,40,13,1,5,8,19,79,False,1514,Michigan State
15,School Totals,200,29,60,.483,21,34,.618,8,26,.308,14,18,.778,9,25,34,19,7,6,8,17,80,False,1515,Michigan State
16,School Totals,200,30,55,.545,18,27,.667,12,28,.429,11,16,.688,5,26,31,27,2,5,17,15,83,False,1516,Michigan State
16,School Totals,200,30,70,.429,23,48,.479,7,22,.318,13,16,.813,11,35,46,26,9,12,12,21,80,False,1517,Michigan State
11,School Totals,200,27,63,.429,22,43,.512,5,20,.250,16,25,.640,12,34,46,9,6,3,15,22,75,False,1518,Michigan State
12,School Totals,200,29,60,.483,23,42,.548,6,18,.333,19,23,.826,10,26,36,16,5,7,17,16,83,False,1519,Michigan State
15,School Totals,200,32,63,.508,22,37,.595,10,26,.385,5,7,.714,6,27,33,28,4,6,11,14,79,False,1520,Michigan State
16,School Totals,200,39,76,.513,24,39,.615,15,37,.405,16,17,.941,16,30,46,32,4,3,16,20,109,False,1521,Michigan State
14,School Totals,200,26,67,.388,18,36,.500,8,31,.258,5,10,.500,11,22,33,19,7,1,8,16,65,False,1522,Michigan State
11,School Totals,200,27,57,.474,19,46,.413,8,11,.727,14,16,.875,9,20,29,23,2,0,14,26,76,False,1523,Michigan State
14,School Totals,200,18,70,.257,12,45,.267,6,25,.240,14,18,.778,11,23,34,10,4,2,6,15,56,False,1524,Michigan State
13,School Totals,200,29,56,.518,22,33,.667,7,23,.304,19,26,.731,9,19,28,12,6,5,12,21,84,False,1525,Michigan State
15,School Totals,200,23,49,.469,17,35,.486,6,14,.429,16,19,.842,8,35,43,16,5,8,15,15,68,False,1526,Michigan State
13,School Totals,200,16,41,.390,13,28,.464,3,13,.231,19,25,.760,6,24,30,12,4,9,14,22,54,False,1527,Michigan State
14,School Totals,200,16,56,.286,12,36,.333,4,20,.200,1,5,.200,10,19,29,8,4,4,19,15,37,False,1528,Michigan State
12,School Totals,200,17,53,.321,12,29,.414,5,24,.208,23,31,.742,6,27,33,11,2,2,10,24,62,False,1529,Michigan State
12,School Totals,200,28,70,.400,16,41,.390,12,29,.414,10,15,.667,19,18,37,16,3,4,8,28,78,False,1530,Michigan State
14,School Totals,200,23,59,.390,17,36,.472,6,23,.261,14,16,.875,8,35,43,16,7,7,20,24,66,False,1531,Michigan State
13,School Totals,200,23,55,.418,19,40,.475,4,15,.267,10,15,.667,9,26,35,15,5,3,9,15,60,False,1532,Michigan State
16,School Totals,200,22,62,.355,16,41,.390,6,21,.286,8,16,.500,10,24,34,18,3,2,7,19,58,False,1533,Michigan State
13,School Totals,200,23,52,.442,16,36,.444,7,16,.438,12,18,.667,11,24,35,12,2,2,16,25,65,False,1534,Michigan State
12,School Totals,200,29,59,.492,22,42,.524,7,17,.412,13,15,.867,11,20,31,12,4,4,14,20,78,False,389,Michigan State
12,School Totals,200,32,59,.542,28,51,.549,4,8,.500,13,20,.650,8,26,34,18,7,9,8,24,81,False,1535,Michigan State
12,School Totals,200,24,50,.480,20,35,.571,4,15,.267,19,25,.760,6,24,30,19,4,5,15,21,71,False,1536,Michigan State
12,School Totals,200,19,57,.333,11,29,.379,8,28,.286,9,15,.600,13,20,33,13,2,3,8,19,55,False,777,Michigan State
12,School Totals,200,20,53,.377,16,36,.444,4,17,.235,20,30,.667,13,30,43,11,5,10,9,21,64,False,392,Michigan State
15,School Totals,200,20,55,.364,20,46,.435,0,9,.000,10,14,.714,7,20,27,7,5,5,11,16,50,False,1165,Michigan State
12,School Totals,200,24,54,.444,20,43,.465,4,11,.364,18,23,.783,8,28,36,12,5,2,8,18,70,False,1166,Michigan State
13,School Totals,200,22,53,.415,18,37,.486,4,16,.250,9,18,.500,8,28,36,10,7,3,18,23,57,False,780,Michigan State
12,School Totals,225,29,61,.475,23,43,.535,6,18,.333,16,18,.889,10,21,31,16,2,6,11,19,80,False,1537,Michigan State
13,School Totals,200,39,73,.534,25,40,.625,14,33,.424,8,12,.667,12,31,43,29,8,6,6,19,100,False,1538,Ohio State
14,School Totals,200,30,66,.455,26,49,.531,4,17,.235,8,12,.667,8,27,35,13,11,4,9,14,72,False,1539,Ohio State
9,School Totals,200,26,60,.433,20,39,.513,6,21,.286,15,22,.682,13,19,32,10,8,3,16,22,73,False,1540,Ohio State
10,School Totals,201,25,50,.500,19,35,.543,6,15,.400,20,30,.667,4,26,30,15,6,11,10,15,76,False,1541,Ohio State
11,School Totals,200,33,57,.579,22,35,.629,11,22,.500,7,17,.412,8,19,27,18,8,7,14,15,84,False,1542,Ohio State
13,School Totals,200,39,62,.629,26,31,.839,13,31,.419,19,22,.864,14,30,44,22,12,11,10,16,110,False,1543,Ohio State
8,School Totals,200,25,58,.431,13,30,.433,12,28,.429,15,26,.577,10,22,32,14,9,4,12,14,77,False,1544,Ohio State
13,School Totals,200,38,60,.633,22,31,.710,16,29,.552,19,28,.679,8,24,32,27,9,2,10,14,111,False,1545,Ohio State
8,School Totals,200,25,51,.490,20,34,.588,5,17,.294,11,18,.611,5,22,27,12,4,8,10,19,66,False,1546,Ohio State
13,School Totals,200,29,54,.537,20,33,.606,9,21,.429,11,19,.579,8,27,35,16,8,4,11,13,78,False,1547,Ohio State
8,School Totals,200,22,37,.595,16,20,.800,6,17,.353,10,14,.714,5,11,16,14,6,4,13,10,60,False,1548,Ohio State
8,School Totals,200,21,44,.477,14,30,.467,7,14,.500,23,31,.742,6,22,28,14,6,7,15,13,72,False,1549,Ohio State
10,School Totals,200,14,43,.326,10,30,.333,4,13,.308,11,19,.579,2,21,23,5,8,4,11,16,43,False,1550,Ohio State
8,School Totals,200,24,65,.369,14,33,.424,10,32,.313,6,8,.750,17,19,36,13,5,2,13,17,64,False,795,Ohio State
14,School Totals,200,24,52,.462,16,33,.485,8,19,.421,23,32,.719,6,25,31,16,8,0,15,20,79,False,13,Ohio State
9,School Totals,200,25,55,.455,20,37,.541,5,18,.278,7,13,.538,9,16,25,13,12,3,17,20,62,False,1551,Ohio State
9,School Totals,200,25,49,.510,20,38,.526,5,11,.455,15,18,.833,8,23,31,10,9,2,16,12,70,False,1552,Ohio State
10,School Totals,200,24,46,.522,21,40,.525,3,6,.500,9,12,.750,5,19,24,10,5,2,11,16,60,False,1553,Ohio State
14,School Totals,200,27,52,.519,20,28,.714,7,24,.292,15,20,.750,9,23,32,19,6,1,10,14,76,False,1554,Ohio State
8,School Totals,200,24,49,.490,18,35,.514,6,14,.429,11,16,.688,3,20,23,11,6,5,10,18,65,False,1555,Ohio State
9,School Totals,200,24,57,.421,20,41,.488,4,16,.250,13,20,.650,13,25,38,12,3,5,5,13,65,False,1556,Ohio State
11,School Totals,200,34,54,.630,25,34,.735,9,20,.450,8,11,.727,4,22,26,22,10,3,12,12,85,False,1557,Ohio State
8,School Totals,200,25,50,.500,18,30,.600,7,20,.350,18,24,.750,7,21,28,12,6,2,6,16,75,False,1558,Ohio State
7,School Totals,200,22,49,.449,20,36,.556,2,13,.154,22,27,.815,12,17,29,8,8,4,7,14,68,False,1559,Ohio State
12,School Totals,200,27,56,.482,25,46,.543,2,10,.200,13,16,.813,4,26,30,17,4,9,6,17,69,False,22,Ohio State
13,School Totals,200,26,49,.531,15,27,.556,11,22,.500,9,15,.600,2,26,28,20,6,1,13,11,72,False,1560,Ohio State
7,School Totals,200,20,48,.417,16,33,.485,4,15,.267,13,18,.722,4,17,21,6,6,3,14,13,57,False,1561,Ohio State
7,School Totals,200,25,59,.424,18,42,.429,7,17,.412,17,23,.739,9,29,38,13,6,3,8,17,74,False,1197,Ohio State
8,School Totals,200,26,54,.481,22,37,.595,4,17,.235,19,24,.792,5,22,27,12,6,5,8,17,75,False,1562,Ohio State
9,School Totals,200,27,46,.587,23,36,.639,4,10,.400,8,15,.533,7,28,35,17,1,5,12,16,66,False,809,Ohio State
14,School Totals,201,24,54,.444,14,33,.424,10,21,.476,15,24,.625,9,24,33,16,8,3,10,11,73,False,1563,Ohio State
8,School Totals,200,27,52,.519,20,40,.500,7,12,.583,8,10,.800,6,15,21,15,6,2,11,15,69,False,813,Ohio State
9,School Totals,250,32,67,.478,23,42,.548,9,25,.360,15,24,.625,11,26,37,13,11,1,18,13,88,False,1564,Ohio State
8,School Totals,200,21,52,.404,11,30,.367,10,22,.455,16,18,.889,7,29,36,14,5,12,9,12,68,False,1566,Ohio State
8,School Totals,200,25,51,.490,17,30,.567,8,21,.381,17,23,.739,7,21,28,17,8,3,18,17,75,False,1567,Ohio State
8,School Totals,200,25,58,.431,16,35,.457,9,23,.391,14,19,.737,10,13,23,14,6,3,11,16,73,False,1568,Ohio State
11,School Totals,200,37,76,.487,32,54,.593,5,22,.227,23,30,.767,28,27,55,24,6,8,14,22,102,False,1569,Ohio State
11,School Totals,200,39,62,.629,30,41,.732,9,21,.429,6,10,.600,7,10,17,22,6,2,8,16,93,False,1570,Ohio State
11,School Totals,200,29,64,.453,19,35,.543,10,29,.345,13,18,.722,16,31,47,16,9,6,12,10,81,False,1571,Ohio State
8,School Totals,200,26,49,.531,20,32,.625,6,17,.353,6,11,.545,5,24,29,17,9,3,16,12,64,False,1572,Ohio State
11,School Totals,200,25,48,.521,17,33,.515,8,15,.533,8,14,.571,8,21,29,16,9,3,13,12,66,False,1573,Ohio State
9,School Totals,200,19,59,.322,15,39,.385,4,20,.200,16,21,.762,14,25,39,6,11,4,15,15,58,False,1574,Ohio State
7,School Totals,200,26,51,0.51,21,40,0.525,5,11,0.455,18,26,0.692,9,22,31,16,7,1,8,14,75,False,1575,Ohio State
12,School Totals,200,28,54,.519,21,39,.538,7,15,.467,22,30,.733,5,19,24,19,8,3,6,9,85,False,1576,Ohio State
12,School Totals,200,32,66,.485,19,38,.500,13,28,.464,6,9,.667,12,23,35,23,11,4,12,16,83,False,1577,Ohio State
12,School Totals,200,27,63,.429,23,47,.489,4,16,.250,21,28,.750,13,30,43,14,6,7,8,11,79,False,1578,Ohio State
12,School Totals,200,39,69,.565,28,45,.622,11,24,.458,7,14,.500,15,27,42,20,12,1,11,12,96,False,1579,Ohio State
11,School Totals,200,33,71,.465,23,53,.434,10,18,.556,16,24,.667,14,25,39,21,11,6,5,13,92,False,1580,Ohio State
11,School Totals,200,41,70,.586,35,48,.729,6,22,.273,12,13,.923,13,31,44,26,13,3,9,8,100,False,1581,Ohio State
10,School Totals,200,23,38,.605,10,19,.526,13,19,.684,26,38,.684,5,21,26,15,4,4,14,20,85,False,45,Ohio State
8,School Totals,200,31,56,.554,24,37,.649,7,19,.368,4,9,.444,10,19,29,20,8,8,15,17,73,False,1582,Ohio State
8,School Totals,200,22,56,.393,14,34,.412,8,22,.364,15,23,.652,9,17,26,14,6,2,12,20,67,False,1583,Ohio State
9,School Totals,200,22,42,.524,15,28,.536,7,14,.500,17,25,.680,7,17,24,12,1,1,10,15,68,False,830,Ohio State
8,School Totals,200,25,51,.490,15,31,.484,10,20,.500,9,13,.692,4,11,15,19,5,2,5,14,69,False,1584,Ohio State
10,School Totals,200,26,55,.473,20,34,.588,6,21,.286,12,15,.800,10,20,30,18,11,2,20,12,70,False,1585,Ohio State
8,School Totals,200,21,53,.396,14,38,.368,7,15,.467,24,27,.889,8,21,29,12,3,4,7,14,73,False,1586,Ohio State
10,School Totals,200,32,58,.552,21,39,.538,11,19,.579,12,22,.545,9,30,39,20,5,0,12,16,87,False,1587,Ohio State
9,School Totals,200,21,37,.568,19,29,.655,2,8,.250,14,20,.700,2,16,18,7,4,3,5,13,58,False,1588,Ohio State
8,School Totals,200,21,47,.447,16,32,.500,5,15,.333,15,25,.600,8,24,32,10,7,3,14,11,62,False,835,Ohio State
10,School Totals,200,32,71,.451,24,51,.471,8,20,.400,10,20,.500,20,16,36,18,9,3,8,21,82,False,1589,Ohio State
8,School Totals,200,25,46,.543,22,37,.595,3,9,.333,14,16,.875,4,21,25,12,5,2,7,14,67,False,1590,Ohio State
8,School Totals,200,21,49,.429,15,32,.469,6,17,.353,23,29,.793,5,14,19,10,9,1,7,12,71,False,1227,Ohio State
8,School Totals,200,18,47,.383,14,32,.438,4,15,.267,23,29,.793,9,20,29,9,12,2,18,17,63,False,1591,Ohio State
10,School Totals,200,35,66,.530,28,51,.549,7,15,.467,12,15,.800,12,17,29,11,9,1,3,9,89,False,1592,Ohio State
11,School Totals,200,24,49,.490,17,31,.548,7,18,.389,27,36,.750,8,26,34,17,8,2,10,22,82,False,59,Ohio State
11,School Totals,200,31,56,.554,18,32,.563,13,24,.542,7,10,.700,10,21,31,21,7,1,12,18,82,False,1593,Ohio State
11,School Totals,200,32,47,.681,18,32,.563,14,15,.933,15,20,.750,4,25,29,18,2,0,7,12,93,False,1594,Ohio State
8,School Totals,225,19,59,.322,16,44,.364,3,15,.200,26,32,.813,17,24,41,3,4,7,6,16,67,False,1595,Ohio State
9,School Totals,200,25,54,.463,20,40,.500,5,14,.357,13,23,.565,9,25,34,11,5,6,9,13,68,False,844,Ohio State
8,School Totals,200,26,51,.510,19,35,.543,7,16,.438,12,20,.600,7,20,27,14,2,8,7,9,71,False,1596,Ohio State
11,School Totals,200,29,52,.558,17,28,.607,12,24,.500,5,8,.625,11,23,34,26,5,3,13,9,75,False,1597,Ohio State
11,School Totals,200,36,59,.610,20,33,.606,16,26,.615,10,18,.556,10,21,31,23,8,1,9,11,98,False,1598,Ohio State
8,School Totals,200,19,58,.328,13,42,.310,6,16,.375,16,22,.727,10,20,30,7,6,1,7,14,60,False,1599,Ohio State
13,School Totals,200,21,47,.447,16,33,.485,5,14,.357,26,38,.684,6,27,33,14,10,3,14,18,73,False,1600,Ohio State
10,School Totals,200,25,53,.472,21,38,.553,4,15,.267,27,34,.794,5,20,25,16,8,2,7,18,81,False,1601,Ohio State
13,School Totals,200,34,71,.479,31,56,.554,3,15,.200,14,22,.636,22,19,41,22,15,3,12,8,85,False,1602,Ohio State
13,School Totals,200,28,60,.467,24,43,.558,4,17,.235,25,40,.625,12,31,43,17,10,1,11,19,85,False,1603,Ohio State
13,School Totals,200,46,68,.676,41,58,.707,5,10,.500,10,17,.588,9,35,44,30,9,4,19,19,107,False,1604,Ohio State
12,School Totals,200,31,60,.517,25,44,.568,6,16,.375,12,21,.571,9,26,35,23,12,1,6,11,80,False,1605,Ohio State
12,School Totals,200,35,59,.593,27,45,.600,8,14,.571,7,10,.700,7,25,32,18,4,2,10,15,85,False,1606,Ohio State
12,School Totals,200,25,63,.397,22,50,.440,3,13,.231,11,15,.733,20,21,41,14,4,3,8,9,64,False,1607,Ohio State
10,School Totals,200,24,62,.387,19,45,.422,5,17,.294,14,18,.778,12,15,27,12,8,0,15,22,67,False,1608,Ohio State
13,School Totals,200,29,51,.569,25,39,.641,4,12,.333,20,24,.833,4,15,19,19,13,3,13,17,82,False,1609,Ohio State
11,School Totals,200,27,53,.509,22,38,.579,5,15,.333,15,20,.750,14,19,33,16,7,3,13,19,74,False,1610,Ohio State
12,School Totals,200,28,62,.452,22,45,.489,6,17,.353,8,19,.421,11,28,39,19,4,4,9,14,70,False,1611,Ohio State
13,School Totals,200,26,58,.448,22,43,.512,4,15,.267,13,17,.765,5,25,30,18,9,2,5,12,69,False,1612,Ohio State
14,School Totals,200,29,61,.475,19,41,.463,10,20,.500,19,30,.633,14,34,48,15,4,3,9,17,87,False,1613,Ohio State
12,School Totals,200,24,49,.490,21,38,.553,3,11,.273,19,26,.731,8,26,34,11,6,5,17,22,70,False,76,Ohio State
14,School Totals,200,30,56,.536,28,39,.718,2,17,.118,9,13,.692,14,28,42,11,8,5,19,13,71,False,1614,Ohio State
14,School Totals,200,33,64,.516,26,50,.520,7,14,.500,3,7,.429,10,29,39,21,12,2,15,18,76,False,1615,Ohio State
9,School Totals,200,31,66,.470,26,51,.510,5,15,.333,7,9,.778,13,13,26,10,6,0,11,15,74,False,1616,Ohio State
12,School Totals,200,31,57,.544,25,42,.595,6,15,.400,12,19,.632,10,20,30,16,10,5,12,15,80,False,80,Ohio State
14,School Totals,200,26,59,.441,18,38,.474,8,21,.381,19,28,.679,10,21,31,13,13,5,10,21,79,False,1617,Ohio State
14,School Totals,200,25,50,.500,21,39,.538,4,11,.364,24,34,.706,7,34,41,16,1,8,13,17,78,False,1618,Ohio State
10,School Totals,200,23,54,.426,20,39,.513,3,15,.200,15,18,.833,14,23,37,10,6,2,10,13,64,False,867,Ohio State
9,School Totals,200,22,51,.431,21,44,.477,1,7,.143,13,16,.813,9,21,30,8,5,1,9,12,58,False,1619,Ohio State
11,School Totals,200,26,50,.520,17,34,.500,9,16,.563,26,34,.765,11,20,31,11,0,2,7,16,87,False,1620,Ohio State
8,School Totals,200,14,53,.264,12,38,.316,2,15,.133,18,22,.818,13,19,32,6,7,2,15,13,48,False,1257,Ohio State
11,School Totals,200,25,56,.446,19,37,.514,6,19,.316,22,28,.786,11,20,31,15,10,4,9,21,78,False,1621,Ohio State
10,School Totals,200,19,49,.388,16,33,.485,3,16,.188,10,15,.667,12,22,34,9,7,0,12,13,51,False,871,Ohio State
14,School Totals,200,32,49,.653,25,36,.694,7,13,.538,12,18,.667,5,27,32,16,6,3,17,17,83,False,1622,Ohio State
10,School Totals,200,23,49,.469,19,38,.500,4,11,.364,10,19,.526,8,26,34,10,2,2,12,17,60,False,1623,Ohio State
9,School Totals,200,29,58,.500,23,39,.590,6,19,.316,11,16,.688,18,24,42,20,5,4,16,17,75,False,1624,Ohio State
9,School Totals,200,24,57,.421,20,43,.465,4,14,.286,20,28,.714,9,24,33,17,9,1,10,19,72,False,1262,Ohio State
13,School Totals,200,37,61,.607,33,45,.733,4,16,.250,10,14,.714,7,28,35,16,1,6,7,15,88,False,1625,Ohio State
14,School Totals,200,31,63,.492,26,49,.531,5,14,.357,10,14,.714,12,22,34,14,11,7,11,17,77,False,877,Ohio State
10,School Totals,200,25,63,.397,21,46,.457,4,17,.235,10,15,.667,14,21,35,6,3,4,10,17,64,False,1265,Ohio State
10,School Totals,200,26,58,.448,21,44,.477,5,14,.357,21,26,.808,14,32,46,11,6,8,18,19,78,False,1626,Ohio State
10,School Totals,200,25,53,.472,16,29,.552,9,24,.375,14,18,.778,7,19,26,13,6,4,11,17,73,False,1627,Ohio State
9,School Totals,200,27,56,.482,19,39,.487,8,17,.471,19,27,.704,11,22,33,14,13,1,11,11,81,False,1628,Ohio State
10,School Totals,200,21,51,.412,17,38,.447,4,13,.308,31,42,.738,13,24,37,10,4,3,11,20,77,False,1629,Ohio State
9,School Totals,200,20,59,.339,12,37,.324,8,22,.364,14,15,.933,10,20,30,11,7,7,12,17,62,False,1630,Ohio State
10,School Totals,200,32,56,.571,20,36,.556,12,20,.600,6,13,.462,8,20,28,18,5,4,11,20,82,False,1631,Ohio State
11,School Totals,200,24,55,.436,16,36,.444,8,19,.421,13,18,.722,12,20,32,9,5,3,7,14,69,False,1632,Ohio State
9,School Totals,200,27,57,.474,24,45,.533,3,12,.250,20,26,.769,12,18,30,14,9,3,6,17,77,False,1633,Ohio State
12,School Totals,200,31,51,.608,22,35,.629,9,16,.563,20,30,.667,9,31,40,21,8,10,13,17,91,False,1634,Ohio State
9,School Totals,200,23,68,.338,17,47,.362,6,21,.286,16,22,.727,16,19,35,6,4,2,7,23,68,False,1635,Ohio State
12,School Totals,200,23,61,.377,16,38,.421,7,23,.304,17,20,.850,14,28,42,14,10,5,11,9,70,False,1636,Ohio State
12,School Totals,200,31,66,.470,21,36,.583,10,30,.333,17,23,.739,14,31,45,22,6,3,9,19,89,False,1637,Ohio State
13,School Totals,200,28,59,.475,18,40,.450,10,19,.526,19,26,.731,19,29,48,15,12,5,20,13,85,False,1638,Ohio State
12,School Totals,200,36,61,.590,30,43,.698,6,18,.333,12,19,.632,6,25,31,25,10,5,12,20,90,False,1639,Ohio State
10,School Totals,200,22,57,.386,16,36,.444,6,21,.286,15,20,.750,10,26,36,14,7,3,5,17,65,False,1640,Ohio State
9,School Totals,200,20,65,.308,12,34,.353,8,31,.258,18,26,.692,14,19,33,11,8,3,13,23,66,False,1641,Ohio State
12,School Totals,200,33,58,.569,25,41,.610,8,17,.471,13,27,.481,11,33,44,20,3,4,10,16,87,False,1642,Ohio State
12,School Totals,200,29,59,.492,22,42,.524,7,17,.412,5,13,.385,9,32,41,16,7,6,9,8,70,False,1643,Ohio State
11,School Totals,200,20,60,.333,16,41,.390,4,19,.211,11,16,.688,8,20,28,10,11,1,16,15,55,False,1644,Ohio State
9,School Totals,200,31,55,.564,27,45,.600,4,10,.400,8,15,.533,8,27,35,13,3,9,13,15,74,False,1645,Ohio State
9,School Totals,200,22,50,.440,17,35,.486,5,15,.333,7,8,.875,6,24,30,11,5,4,12,14,56,False,895,Ohio State
9,School Totals,200,19,47,.404,9,22,.409,10,25,.400,8,13,.615,5,17,22,15,6,2,14,16,56,False,1287,Ohio State
9,School Totals,200,27,52,.519,23,42,.548,4,10,.400,14,19,.737,10,21,31,12,8,9,17,19,72,False,1646,Ohio State
11,School Totals,200,21,48,.438,17,39,.436,4,9,.444,19,23,.826,6,32,38,10,3,4,8,17,65,False,1647,Ohio State
9,School Totals,200,23,45,.511,20,40,.500,3,5,.600,9,12,.750,4,25,29,10,4,4,10,12,58,False,1648,Ohio State
9,School Totals,200,18,46,.391,14,34,.412,4,12,.333,23,28,.821,6,24,30,8,4,6,11,10,63,False,1649,Ohio State
9,School Totals,225,30,58,.517,23,42,.548,7,16,.438,7,10,.700,9,19,28,15,7,7,11,11,74,False,900,Ohio State
10,School Totals,200,25,59,.424,22,46,.478,3,13,.231,15,20,.750,11,19,30,9,4,4,12,27,68,False,122,Ohio State
10,School Totals,200,25,55,.455,20,38,.526,5,17,.294,14,22,.636,16,21,37,15,5,4,9,12,69,False,1650,Ohio State
11,School Totals,200,21,56,.375,18,44,.409,3,12,.250,4,11,.364,9,20,29,6,5,3,9,16,49,False,1651,Ohio State
13,School Totals,200,24,60,.400,17,40,.425,7,20,.350,16,18,.889,8,22,30,13,10,5,11,21,71,False,1652,Ohio State
9,School Totals,200,22,50,.440,17,32,.531,5,18,.278,19,23,.826,4,21,25,8,4,1,9,16,68,False,1293,Ohio State
11,School Totals,200,21,49,.429,13,27,.481,8,22,.364,13,23,.565,9,20,29,15,10,6,6,12,63,False,1653,Ohio State
9,School Totals,200,27,59,.458,25,51,.490,2,8,.250,11,16,.688,9,25,34,9,8,7,7,17,67,False,128,Ohio State
9,School Totals,200,23,49,.469,19,34,.559,4,15,.267,18,25,.720,8,28,36,11,8,1,13,13,68,False,1654,Ohio State
12,School Totals,200,26,44,.591,17,27,.630,9,17,.529,10,14,.714,3,21,24,20,10,4,11,11,71,False,1655,Ohio State
9,School Totals,200,24,57,.421,17,33,.515,7,24,.292,6,12,.500,8,20,28,17,9,4,5,11,61,False,1297,Ohio State
9,School Totals,200,20,52,.385,19,36,.528,1,16,.063,9,12,.750,10,27,37,8,6,1,9,12,50,False,1656,Ohio State
13,School Totals,200,34,71,.479,27,56,.482,7,15,.467,20,25,.800,11,30,41,25,8,7,10,17,95,False,1657,Ohio State
9,School Totals,200,25,49,.510,16,31,.516,9,18,.500,19,26,.731,2,18,20,12,7,2,9,20,78,False,1658,Ohio State
9,School Totals,201,22,52,.423,15,39,.385,7,13,.538,22,26,.846,8,21,29,9,4,3,8,18,73,False,1659,Ohio State
9,School Totals,200,19,61,.311,14,36,.389,5,25,.200,23,29,.793,8,26,34,7,5,8,9,22,66,False,1660,Ohio State
11,School Totals,200,31,65,.477,20,40,.500,11,25,.440,16,22,.727,17,35,52,18,3,5,16,16,89,False,1661,Ohio State
10,School Totals,200,18,44,.409,13,26,.500,5,18,.278,38,51,.745,10,21,31,9,4,4,9,21,79,False,1662,Ohio State
10,School Totals,200,22,52,.423,19,34,.559,3,18,.167,5,15,.333,5,27,32,16,10,8,11,19,52,False,1663,Ohio State
10,School Totals,200,20,56,.357,17,40,.425,3,16,.188,20,29,.690,14,18,32,10,15,2,14,10,63,False,1664,Ohio State
10,School Totals,200,23,56,.411,15,33,.455,8,23,.348,11,16,.688,13,28,41,8,2,7,6,15,65,False,1665,Ohio State
11,School Totals,199,36,52,.692,22,29,.759,14,23,.609,13,22,.591,6,24,30,20,9,1,12,16,99,False,1666,Ohio State
10,School Totals,200,25,48,.521,17,30,.567,8,18,.444,18,29,.621,5,22,27,11,8,4,11,15,76,False,537,Ohio State
10,School Totals,200,29,55,.527,25,38,.658,4,17,.235,12,18,.667,10,16,26,10,6,7,11,12,74,False,1667,Ohio State
11,School Totals,201,32,61,.525,24,41,.585,8,20,.400,14,20,.700,9,28,37,16,13,10,8,11,86,False,1668,Ohio State
11,School Totals,200,27,51,.529,17,31,.548,10,20,.500,15,21,.714,8,25,33,16,5,1,10,16,79,False,1669,Ohio State
10,School Totals,200,24,59,.407,18,41,.439,6,18,.333,22,32,.688,16,29,45,7,8,7,13,14,76,False,1670,Ohio State
10,School Totals,200,23,55,.418,20,37,.541,3,18,.167,15,20,.750,7,25,32,12,8,1,11,18,64,False,1671,Ohio State
11,School Totals,200,23,52,.442,15,29,.517,8,23,.348,17,20,.850,11,27,38,14,5,6,9,14,71,False,1672,Ohio State
10,School Totals,200,29,65,.446,25,43,.581,4,22,.182,16,24,.667,9,27,36,21,7,6,6,17,78,False,1673,Ohio State
11,School Totals,200,27,50,.540,18,31,.581,9,19,.474,21,29,.724,4,28,32,14,7,5,7,15,84,False,1674,Ohio State
10,School Totals,225,24,58,.414,20,40,.500,4,18,.222,16,24,.667,11,27,38,14,8,5,19,16,68,False,1314,Ohio State
10,School Totals,200,25,56,.446,18,35,.514,7,21,.333,17,24,.708,7,22,29,15,8,1,17,22,74,False,1675,Ohio State
9,School Totals,200,18,51,.353,12,35,.343,6,16,.375,11,18,.611,8,16,24,11,8,3,13,18,53,False,1676,Ohio State
10,School Totals,200,21,53,.396,15,32,.469,6,21,.286,14,21,.667,7,19,26,9,9,4,13,25,62,False,1677,Ohio State
10,School Totals,200,20,48,.417,12,29,.414,8,19,.421,14,19,.737,8,19,27,11,10,3,12,13,62,False,1678,Ohio State
10,School Totals,224,21,55,.382,16,39,.410,5,16,.313,23,29,.793,6,21,27,9,10,2,7,10,70,False,1679,Ohio State
10,School Totals,200,21,49,.429,16,40,.400,5,9,.556,12,18,.667,8,21,29,9,4,2,8,23,59,False,1680,Ohio State
10,School Totals,200,25,49,.510,18,33,.545,7,16,.438,19,24,.792,3,19,22,12,10,2,13,20,76,False,1681,Ohio State
10,School Totals,200,25,54,.463,17,35,.486,8,19,.421,9,13,.692,7,19,26,15,5,4,7,13,67,False,1682,Ohio State
10,School Totals,200,23,52,.442,20,32,.625,3,20,.150,11,16,.688,8,18,26,7,4,2,8,17,60,False,938,Ohio State
10,School Totals,200,18,47,.383,15,34,.441,3,13,.231,9,15,.600,4,25,29,6,10,7,11,12,48,False,1683,Ohio State
12,School Totals,200,23,50,.460,16,34,.471,7,16,.438,23,29,.793,10,23,33,10,8,4,10,18,76,False,1684,Ohio State
12,School Totals,200,23,52,.442,20,38,.526,3,14,.214,15,17,.882,9,22,31,12,7,6,11,12,64,False,1685,Ohio State
10,School Totals,200,20,47,.426,15,30,.500,5,17,.294,18,27,.667,5,18,23,12,7,6,11,24,63,False,1686,Ohio State
10,School Totals,200,25,59,.424,25,48,.521,0,11,.000,14,23,.609,10,21,31,5,7,7,14,22,64,False,163,Ohio State
9,School Totals,200,23,49,.469,19,39,.487,4,10,.400,19,31,.613,7,18,25,12,10,2,10,12,69,False,1327,Ohio State
10,School Totals,200,23,64,.359,22,50,.440,1,14,.071,16,25,.640,17,21,38,9,9,10,12,16,63,False,1687,Ohio State
10,School Totals,200,25,55,.455,21,37,.568,4,18,.222,17,28,.607,14,28,42,12,6,7,15,21,71,False,1688,Ohio State
10,School Totals,200,27,56,.482,20,37,.541,7,19,.368,8,12,.667,9,22,31,17,10,2,11,18,69,False,945,Ohio State
10,School Totals,200,24,50,.480,21,38,.553,3,12,.250,8,12,.667,2,24,26,12,10,4,14,16,59,False,1689,Ohio State
10,School Totals,200,37,60,0.617,28,38,0.737,9,22,0.409,9,15,0.6,10,21,31,20,8,1,9,15,92,False,1690,Ohio State
11,School Totals,200,32,49,.653,24,34,.706,8,15,.533,2,4,.500,1,24,25,23,7,3,18,17,74,False,1691,Ohio State
10,School Totals,200,41,72,.569,31,49,.633,10,23,.435,14,18,.778,12,32,44,24,9,8,7,11,106,False,1692,Ohio State
11,School Totals,200,34,56,.607,26,36,.722,8,20,.400,15,19,.789,9,19,28,17,7,4,10,14,91,False,1693,Ohio State
11,School Totals,200,26,63,.413,20,45,.444,6,18,.333,15,21,.714,17,20,37,13,12,7,15,15,73,False,1694,Ohio State
11,School Totals,200,17,56,.304,11,38,.289,6,18,.333,15,25,.600,14,25,39,7,10,4,14,23,55,False,1695,Ohio State
11,School Totals,200,27,58,.466,18,36,.500,9,22,.409,7,11,.636,11,25,36,12,6,6,9,7,70,False,1696,Ohio State
11,School Totals,200,35,56,.625,27,43,.628,8,13,.615,19,28,.679,13,34,47,19,10,3,13,11,97,False,1697,Ohio State
10,School Totals,200,30,53,.566,24,39,.615,6,14,.429,21,27,.778,12,16,28,18,10,8,17,17,87,False,1698,Ohio State
12,School Totals,200,35,62,.565,28,43,.651,7,19,.368,20,22,.909,7,23,30,21,18,2,11,10,97,False,1699,Ohio State
11,School Totals,200,25,72,.347,15,43,.349,10,29,.345,14,18,.778,11,23,34,17,6,11,10,24,74,False,1700,Ohio State
12,School Totals,200,36,66,.545,27,44,.614,9,22,.409,12,22,.545,10,33,43,25,10,4,8,14,93,False,1701,Ohio State
11,School Totals,200,35,57,.614,24,37,.649,11,20,.550,19,23,.826,6,34,40,20,6,9,12,9,100,False,1702,Ohio State
10,School Totals,200,24,57,.421,18,33,.545,6,24,.250,11,15,.733,10,17,27,16,8,4,9,17,65,False,1703,Ohio State
11,School Totals,200,27,45,.600,20,29,.690,7,16,.438,16,22,.727,2,23,25,12,10,3,18,18,77,False,1704,Ohio State
11,School Totals,225,31,61,.508,25,45,.556,6,16,.375,6,12,.500,9,22,31,23,10,8,14,18,74,False,1705,Ohio State
11,School Totals,200,23,67,.343,20,46,.435,3,21,.143,17,27,.630,16,19,35,7,9,7,5,22,66,False,182,Ohio State
10,School Totals,200,28,57,.491,23,39,.590,5,18,.278,10,14,.714,9,23,32,20,11,5,9,16,71,False,967,Ohio State
10,School Totals,200,23,60,.383,16,42,.381,7,18,.389,14,21,.667,14,16,30,8,4,3,9,24,67,False,1706,Ohio State
11,School Totals,200,28,53,.528,19,34,.559,9,19,.474,4,9,.444,8,17,25,15,2,6,9,15,69,False,1707,Ohio State
10,School Totals,200,33,53,.623,28,38,.737,5,15,.333,11,14,.786,4,16,20,16,5,3,7,13,82,False,186,Ohio State
12,School Totals,200,28,60,.467,18,43,.419,10,17,.588,14,26,.538,16,35,51,13,4,4,9,17,80,False,582,Ohio State
10,School Totals,200,24,57,.421,20,42,.476,4,15,.267,6,9,.667,12,15,27,12,9,6,12,23,58,False,1708,Ohio State
11,School Totals,200,30,59,.508,24,41,.585,6,18,.333,13,23,.565,12,33,45,21,8,6,15,21,79,False,1709,Ohio State
10,School Totals,200,24,54,.444,18,38,.474,6,16,.375,21,31,.677,6,31,37,15,6,7,12,16,75,False,1710,Ohio State
10,School Totals,200,23,52,.442,18,35,.514,5,17,.294,5,13,.385,10,18,28,13,5,5,9,12,56,False,1354,Ohio State
10,School Totals,200,22,52,.423,17,33,.515,5,19,.263,8,12,.667,13,22,35,9,3,4,13,16,57,False,976,Ohio State
11,School Totals,200,28,52,.538,17,33,.515,11,19,.579,14,22,.636,7,21,28,16,8,6,11,13,81,False,1711,Ohio State
10,School Totals,200,19,48,.396,17,36,.472,2,12,.167,25,35,.714,9,21,30,4,10,6,12,18,65,False,1712,Ohio State
10,School Totals,200,24,56,.429,18,39,.462,6,17,.353,23,36,.639,10,26,36,11,7,1,9,22,77,False,1713,Ohio State
11,School Totals,200,18,53,.340,15,38,.395,3,15,.200,9,14,.643,9,17,26,9,7,3,9,7,48,False,1714,Ohio State
10,School Totals,200,26,52,.500,21,33,.636,5,19,.263,22,28,.786,9,23,32,17,6,6,14,16,79,False,1715,Ohio State
10,School Totals,200,23,58,.397,16,39,.410,7,19,.368,14,20,.700,8,24,32,16,6,5,12,18,67,False,1359,Ohio State
10,School Totals,225,28,57,.491,22,42,.524,6,15,.400,13,22,.591,7,22,29,16,5,7,11,17,75,False,1716,Ohio State
10,School Totals,200,20,52,.385,15,35,.429,5,17,.294,13,15,.867,5,18,23,9,4,3,12,17,58,False,1717,Ohio State
11,School Totals,200,28,56,.500,22,41,.537,6,15,.400,14,17,.824,13,34,47,10,3,4,17,12,76,False,1718,Ohio State
12,School Totals,200,30,51,.588,21,26,.808,9,25,.360,13,26,.500,8,24,32,13,8,7,17,19,82,False,1719,Ohio State
10,School Totals,200,23,55,.418,14,32,.438,9,23,.391,13,27,.481,12,23,35,12,1,8,13,21,68,False,1720,Ohio State
10,School Totals,200,26,57,.456,21,43,.488,5,14,.357,17,27,.630,15,24,39,8,4,7,14,18,74,False,1721,Ohio State
11,School Totals,225,28,61,.459,19,36,.528,9,25,.360,11,19,.579,5,29,34,17,9,7,17,28,76,False,1722,Ohio State
10,School Totals,200,21,42,.500,13,21,.619,8,21,.381,8,12,.667,3,20,23,10,3,7,12,13,58,False,1723,Ohio State
11,School Totals,200,33,69,.478,25,43,.581,8,26,.308,15,19,.789,14,30,44,14,7,5,9,12,89,False,1724,Ohio State
11,School Totals,200,27,57,.474,21,35,.600,6,22,.273,14,18,.778,5,26,31,11,8,6,12,18,74,False,1725,Ohio State
11,School Totals,200,20,56,.357,15,34,.441,5,22,.227,10,12,.833,7,17,24,11,9,0,13,14,55,False,1726,Ohio State
11,School Totals,200,20,51,.392,12,31,.387,8,20,.400,19,30,.633,10,29,39,10,5,7,14,19,67,False,1727,Ohio State
9,School Totals,200,26,64,.406,17,46,.370,9,18,.500,13,17,.765,11,25,36,10,9,7,10,16,74,False,1728,Ohio State
12,School Totals,200,26,60,.433,23,38,.605,3,22,.136,9,17,.529,13,20,33,10,17,5,16,12,64,False,1729,Ohio State
11,School Totals,200,26,56,.464,18,34,.529,8,22,.364,13,17,.765,11,37,48,19,2,9,14,16,73,False,1730,Ohio State
11,School Totals,200,29,57,.509,24,42,.571,5,15,.333,15,22,.682,9,31,40,24,2,4,12,18,78,False,1731,Ohio State
10,School Totals,200,21,50,.420,16,35,.457,5,15,.333,28,39,.718,9,30,39,10,2,9,14,18,75,False,1732,Ohio State
11,School Totals,200,25,56,.446,20,38,.526,5,18,.278,10,22,.455,9,27,36,18,7,6,12,13,65,False,1733,Ohio State
11,School Totals,200,22,56,.393,15,39,.385,7,17,.412,9,15,.600,7,24,31,8,7,4,13,18,60,False,217,Ohio State
12,School Totals,200,36,73,.493,29,52,.558,7,21,.333,15,24,.625,14,30,44,17,10,4,7,19,94,False,1734,Ohio State
10,School Totals,200,22,59,.373,19,47,.404,3,12,.250,18,25,.720,11,18,29,7,9,4,13,19,65,False,611,Ohio State
11,School Totals,200,23,54,.426,17,40,.425,6,14,.429,12,16,.750,9,20,29,12,2,6,12,24,64,False,1735,Ohio State
12,School Totals,200,24,52,.462,16,33,.485,8,19,.421,10,14,.714,5,33,38,12,3,8,15,12,66,False,1736,Ohio State
10,School Totals,225,27,69,.391,20,46,.435,7,23,.304,7,13,.538,13,38,51,9,4,5,12,22,68,False,1737,Ohio State
11,School Totals,200,21,59,.356,16,44,.364,5,15,.333,14,24,.583,12,21,33,7,6,1,7,21,61,False,615,Ohio State
10,School Totals,200,26,58,.448,19,40,.475,7,18,.389,9,12,.750,10,16,26,8,2,4,10,19,68,False,1738,Ohio State
10,School Totals,200,23,56,.411,17,38,.447,6,18,.333,19,23,.826,9,24,33,8,4,5,5,13,71,False,1739,Ohio State
11,School Totals,200,31,61,.508,22,37,.595,9,24,.375,8,15,.533,11,31,42,17,6,3,19,22,79,False,1740,Ohio State
11,School Totals,200,27,50,.540,22,36,.611,5,14,.357,17,23,.739,2,25,27,14,0,4,9,17,76,False,1005,Ohio State
11,School Totals,225,21,54,.389,18,40,.450,3,14,.214,20,26,.769,15,31,46,6,6,8,16,23,65,False,1741,Ohio State
9,School Totals,200,19,48,.396,14,34,.412,5,14,.357,19,21,.905,7,19,26,4,3,3,10,13,62,False,1390,Ohio State
10,School Totals,200,25,56,.446,20,38,.526,5,18,.278,13,16,.813,9,23,32,11,6,6,15,20,68,False,1742,Ohio State
10,School Totals,200,27,57,.474,16,34,.471,11,23,.478,11,21,.524,4,18,22,15,8,2,9,21,76,False,1393,Ohio State
9,School Totals,200,24,55,.436,19,41,.463,5,14,.357,26,39,.667,10,24,34,9,7,7,11,18,79,False,1743,Ohio State
10,School Totals,200,23,54,.426,22,43,.512,1,11,.091,7,11,.636,6,19,25,8,4,6,14,16,54,False,1394,Ohio State
8,School Totals,225,23,67,.343,18,46,.391,5,21,.238,21,23,.913,14,38,52,9,4,2,12,16,72,False,1744,Ohio State
9,School Totals,200,23,59,.390,17,37,.459,6,22,.273,14,16,.875,9,24,33,9,4,3,13,20,66,False,1745,Ohio State
11,School Totals,200,27,47,.574,17,29,.586,10,18,.556,14,21,.667,6,31,37,20,3,8,16,23,78,False,1746,Ohio State
10,School Totals,200,26,56,.464,20,35,.571,6,21,.286,11,23,.478,10,19,29,14,4,1,12,16,69,False,1747,Ohio State
10,School Totals,200,27,54,.500,23,42,.548,4,12,.333,14,20,.700,5,37,42,14,2,7,11,17,72,False,1748,Ohio State
12,School Totals,200,23,55,.418,18,38,.474,5,17,.294,15,24,.625,15,25,40,11,11,3,14,12,66,False,1749,Ohio State
12,School Totals,200,26,47,.553,13,20,.650,13,27,.481,13,20,.650,4,24,28,20,8,4,16,11,78,False,1750,Ohio State
12,School Totals,200,45,82,.549,35,53,.660,10,29,.345,11,23,.478,27,32,59,22,8,3,10,15,111,False,1751,Ohio State
9,School Totals,200,22,44,.500,16,27,.593,6,17,.353,11,13,.846,5,24,29,14,4,3,19,20,61,False,1752,Ohio State
9,School Totals,200,26,52,.500,20,37,.541,6,15,.400,12,21,.571,8,26,34,16,7,5,14,13,70,False,1753,Ohio State
10,School Totals,225,28,67,.418,24,47,.511,4,20,.200,17,22,.773,9,28,37,16,4,5,12,19,77,False,1754,Ohio State
10,School Totals,200,18,53,.340,16,35,.457,2,18,.111,26,34,.765,11,22,33,6,5,2,7,12,64,False,1755,Ohio State
9,School Totals,200,29,62,.468,24,38,.632,5,24,.208,10,12,.833,5,24,29,17,10,2,18,20,73,False,1756,Ohio State
12,School Totals,200,31,62,.500,26,47,.553,5,15,.333,10,17,.588,9,42,51,19,6,9,15,17,77,False,1757,Ohio State
10,School Totals,200,29,53,.547,26,43,.605,3,10,.300,18,26,.692,8,27,35,15,2,4,13,16,79,False,1758,Ohio State
9,School Totals,200,27,65,.415,20,44,.455,7,21,.333,9,11,.818,9,25,34,10,3,3,8,18,70,False,1759,Ohio State
10,School Totals,200,26,59,.441,20,44,.455,6,15,.400,17,20,.850,6,24,30,10,9,4,11,17,75,False,1760,Ohio State
9,School Totals,200,26,64,.406,21,50,.420,5,14,.357,11,21,.524,10,29,39,17,5,4,14,26,68,False,1761,Ohio State
10,School Totals,200,21,53,.396,16,33,.485,5,20,.250,19,23,.826,10,20,30,7,6,10,12,14,66,False,1762,Ohio State
9,School Totals,200,24,52,.462,14,29,.483,10,23,.435,14,20,.700,5,20,25,13,5,3,11,17,72,False,1415,Ohio State
10,School Totals,200,27,65,.415,21,47,.447,6,18,.333,7,16,.438,12,29,41,9,3,4,11,18,67,False,1763,Ohio State
9,School Totals,200,26,57,.456,18,35,.514,8,22,.364,12,23,.522,11,26,37,12,3,3,13,22,72,False,1764,Ohio State
10,School Totals,200,24,48,.500,17,31,.548,7,17,.412,23,30,.767,6,23,29,12,5,5,15,19,78,False,1765,Ohio State
10,School Totals,200,27,63,.429,20,41,.488,7,22,.318,11,17,.647,11,22,33,19,4,0,12,19,72,False,1766,Ohio State
9,School Totals,200,26,54,.481,19,37,.514,7,17,.412,12,17,.706,9,17,26,17,8,3,10,15,71,False,649,Ohio State
9,School Totals,200,21,52,.404,17,33,.515,4,19,.211,24,28,.857,16,23,39,8,5,2,15,18,70,False,1033,Ohio State
9,School Totals,200,23,50,.460,18,38,.474,5,12,.417,19,25,.760,7,27,34,12,2,6,15,19,70,False,1767,Ohio State
9,School Totals,200,27,56,.482,19,39,.487,8,17,.471,15,18,.833,9,22,31,11,4,3,14,25,77,False,652,Ohio State
10,School Totals,200,25,60,.417,18,42,.429,7,18,.389,9,16,.563,10,21,31,14,6,1,11,21,66,False,1419,Ohio State
9,School Totals,200,19,46,.413,14,29,.483,5,17,.294,14,20,.700,5,26,31,10,5,1,17,10,57,False,1768,Ohio State
9,School Totals,200,25,50,.500,15,34,.441,10,16,.625,23,27,.852,8,28,36,12,4,4,8,21,83,False,1769,Ohio State
9,School Totals,200,25,51,.490,18,31,.581,7,20,.350,14,22,.636,5,30,35,9,7,2,17,15,71,False,1770,Ohio State
9,School Totals,200,33,62,.532,21,41,.512,12,21,.571,14,22,.636,8,22,30,15,4,3,10,21,92,False,266,Ohio State
10,School Totals,200,18,45,.400,12,25,.480,6,20,.300,15,28,.536,6,22,28,13,4,4,13,16,57,False,1771,Ohio State
14,School Totals,200,40,67,.597,35,49,.714,5,18,.278,10,16,.625,16,33,49,16,8,8,19,13,95,False,1772,Ohio State
12,School Totals,200,29,67,.433,21,40,.525,8,27,.296,16,22,.727,14,29,43,10,5,4,15,19,82,False,1773,Ohio State
10,School Totals,200,30,65,.462,21,37,.568,9,28,.321,13,16,.813,11,26,37,19,5,4,10,17,82,False,1774,Ohio State
12,School Totals,200,28,56,.500,25,41,.610,3,15,.200,21,27,.778,7,30,37,13,8,5,9,13,80,False,1775,Ohio State
11,School Totals,200,19,55,.345,13,35,.371,6,20,.300,15,22,.682,9,18,27,14,4,2,15,18,59,False,1776,Ohio State
10,School Totals,200,25,61,.410,16,40,.400,9,21,.429,20,25,.800,11,26,37,13,3,3,14,25,79,False,1777,Ohio State
11,School Totals,225,24,52,.462,19,37,.514,5,15,.333,13,18,.722,5,34,39,13,4,2,24,21,66,False,1778,Ohio State
10,School Totals,200,24,55,.436,15,34,.441,9,21,.429,8,16,.500,8,20,28,15,3,4,12,13,65,False,1779,Ohio State
12,School Totals,200,31,47,.660,24,34,.706,7,13,.538,14,19,.737,4,25,29,19,10,3,13,16,83,False,1780,Ohio State
10,School Totals,200,22,45,.489,17,31,.548,5,14,.357,22,29,.759,5,27,32,12,4,4,10,18,71,False,1056,Ohio State
12,School Totals,200,35,54,.648,24,33,.727,11,21,.524,16,23,.696,9,20,29,19,7,3,11,12,97,False,1781,Ohio State
11,School Totals,200,30,57,.526,27,43,.628,3,14,.214,17,23,.739,5,22,27,13,11,3,11,20,80,False,1782,Ohio State
14,School Totals,200,37,74,.500,24,39,.615,13,35,.371,7,9,.778,15,30,45,27,9,4,12,12,94,False,1783,Ohio State
11,School Totals,200,26,59,.441,21,43,.488,5,16,.313,15,19,.789,3,22,25,11,9,2,14,22,72,False,1784,Ohio State
11,School Totals,200,23,55,.418,15,35,.429,8,20,.400,18,23,.783,8,25,33,10,4,5,11,11,72,False,1785,Ohio State
11,School Totals,200,35,66,.530,28,46,.609,7,20,.350,15,23,.652,10,27,37,16,6,5,9,22,92,False,1786,Ohio State
11,School Totals,200,31,59,.525,24,44,.545,7,15,.467,11,17,.647,4,26,30,15,6,4,6,18,80,False,1443,Ohio State
12,School Totals,200,32,57,.561,15,28,.536,17,29,.586,10,12,.833,5,26,31,25,3,6,9,18,91,False,679,Ohio State
11,School Totals,200,27,58,.466,20,37,.541,7,21,.333,7,10,.700,9,31,40,14,4,6,11,18,68,False,1787,Ohio State
10,School Totals,200,26,55,.473,20,38,.526,6,17,.353,13,17,.765,8,28,36,17,7,3,11,13,71,False,1788,Ohio State
11,School Totals,200,27,66,.409,23,46,.500,4,20,.200,9,10,.900,12,28,40,11,10,5,8,18,67,False,1789,Ohio State
11,School Totals,200,23,52,.442,21,38,.553,2,14,.143,16,23,.696,9,25,34,14,4,2,6,15,64,False,1790,Ohio State
10,School Totals,200,28,50,.560,21,35,.600,7,15,.467,16,16,1.000,4,18,22,12,5,4,10,16,79,False,1791,Ohio State
10,School Totals,200,29,52,.558,24,35,.686,5,17,.294,8,10,.800,9,30,39,13,5,6,14,19,71,False,292,Ohio State
10,School Totals,200,23,50,.460,20,34,.588,3,16,.188,26,33,.788,13,29,42,11,5,0,15,18,75,False,1792,Ohio State
10,School Totals,200,24,57,.421,18,39,.462,6,18,.333,10,16,.625,5,21,26,15,7,1,7,20,64,False,1793,Ohio State
13,School Totals,200,29,55,.527,20,33,.606,9,22,.409,15,21,.714,8,25,33,18,8,3,9,17,82,False,1794,Ohio State
11,School Totals,200,21,54,.389,19,39,.487,2,15,.133,12,17,.706,8,21,29,9,7,3,9,20,56,False,1795,Ohio State
10,School Totals,200,24,58,.414,19,47,.404,5,11,.455,9,19,.474,13,24,37,8,5,5,14,22,62,False,1074,Ohio State
13,School Totals,200,33,56,.589,24,33,.727,9,23,.391,4,6,.667,8,27,35,18,4,4,11,13,79,False,1796,Ohio State
10,School Totals,250,33,69,.478,27,51,.529,6,18,.333,8,13,.615,11,25,36,16,9,8,13,21,80,False,299,Ohio State
9,School Totals,200,26,59,.441,18,36,.500,8,23,.348,8,11,.727,9,17,26,16,4,7,7,18,68,False,1797,Ohio State
10,School Totals,200,27,72,.375,15,32,.469,12,40,.300,15,19,.789,14,30,44,15,10,2,9,15,81,False,1798,Ohio State
10,School Totals,200,30,66,.455,19,40,.475,11,26,.423,13,16,.813,7,16,23,12,6,2,12,24,84,False,1799,Ohio State
9,School Totals,200,20,47,.426,12,27,.444,8,20,.400,16,22,.727,6,21,27,7,2,5,13,22,64,False,1800,Ohio State
13,School Totals,200,34,56,.607,19,28,.679,15,28,.536,24,28,.857,6,29,35,21,6,5,11,18,107,False,1801,Ohio State
10,School Totals,200,26,55,.473,16,34,.471,10,21,.476,7,12,.583,11,20,31,15,4,2,13,18,69,False,1802,Ohio State
13,School Totals,200,28,51,.549,21,32,.656,7,19,.368,26,35,.743,7,30,37,18,4,3,15,17,89,False,1803,Ohio State
10,School Totals,200,23,52,.442,20,32,.625,3,20,.150,19,28,.679,7,29,36,14,4,2,12,13,68,False,1804,Ohio State
13,School Totals,200,34,64,.531,27,45,.600,7,19,.368,14,19,.737,7,27,34,17,11,3,12,21,89,False,1805,Ohio State
10,School Totals,200,15,46,.326,9,24,.375,6,22,.273,26,35,.743,8,20,28,12,5,1,10,17,62,False,1806,Ohio State
12,School Totals,200,28,60,.467,21,43,.488,7,17,.412,16,20,.800,11,28,39,16,5,1,10,26,79,False,1807,Ohio State
11,School Totals,200,24,51,.471,18,34,.529,6,17,.353,23,32,.719,9,27,36,14,8,4,19,22,77,False,1808,Ohio State
10,School Totals,200,27,56,.482,21,41,.512,6,15,.400,13,18,.722,9,30,39,15,2,3,13,14,73,False,1809,Ohio State
13,School Totals,200,26,56,.464,21,37,.568,5,19,.263,18,23,.783,8,27,35,17,5,3,8,13,75,False,1810,Ohio State
10,School Totals,200,28,67,.418,20,44,.455,8,23,.348,16,23,.696,15,24,39,26,5,7,10,18,80,False,1811,Ohio State
13,School Totals,200,30,54,.556,19,29,.655,11,25,.440,11,22,.500,5,21,26,19,5,3,11,14,82,False,1812,Ohio State
12,School Totals,200,27,62,.435,20,38,.526,7,24,.292,16,21,.762,8,18,26,15,7,0,5,26,77,False,1471,Ohio State
10,School Totals,200,23,58,.397,15,32,.469,8,26,.308,7,11,.636,10,19,29,12,7,0,12,18,61,False,1813,Ohio State
11,School Totals,200,22,59,.373,12,34,.353,10,25,.400,8,11,.727,11,25,36,14,9,1,20,23,62,False,1814,Ohio State
11,School Totals,200,23,59,.390,17,33,.515,6,26,.231,9,12,.750,10,16,26,8,6,0,10,15,61,False,709,Ohio State
10,School Totals,200,23,44,.523,13,22,.591,10,22,.455,11,16,.688,4,19,23,11,9,1,18,19,67,False,1815,Ohio State
10,School Totals,200,24,58,.414,15,31,.484,9,27,.333,13,18,.722,12,30,42,8,8,1,12,14,70,False,1816,Ohio State
11,School Totals,200,19,52,.365,14,31,.452,5,21,.238,6,6,1.000,10,24,34,10,4,4,18,17,49,False,1104,Ohio State
10,School Totals,200,27,51,.529,14,23,.609,13,28,.464,9,13,.692,4,21,25,16,5,2,6,16,76,False,1817,Ohio State
10,School Totals,200,22,44,.500,15,30,.500,7,14,.500,23,29,.793,3,27,30,11,5,4,18,21,74,False,1818,Ohio State
11,School Totals,200,23,52,.442,16,36,.444,7,16,.438,2,6,.333,7,22,29,13,5,4,15,15,55,False,324,Ohio State
9,School Totals,200,17,47,.362,15,34,.441,2,13,.154,20,25,.800,8,25,33,8,8,1,18,22,56,False,1819,Ohio State
12,School Totals,200,18,56,.321,14,41,.341,4,15,.267,4,9,.444,7,27,34,9,7,2,15,18,44,False,1480,Ohio State
13,School Totals,200,25,54,.463,21,34,.618,4,20,.200,9,10,.900,5,29,34,18,3,4,8,12,63,False,1820,Ohio State
9,School Totals,200,23,63,.365,12,30,.400,11,33,.333,5,7,.714,9,18,27,14,9,3,7,18,62,False,718,Ohio State
13,School Totals,200,28,58,.483,16,26,.615,12,32,.375,22,24,.917,8,25,33,19,7,3,10,12,90,False,1821,Ohio State
12,School Totals,200,16,48,.333,14,29,.483,2,19,.105,17,25,.680,7,16,23,9,5,1,9,18,51,False,1822,Ohio State
10,School Totals,200,17,64,.266,13,38,.342,4,26,.154,12,17,.706,9,24,33,8,2,2,9,15,50,False,1823,Ohio State
11,School Totals,225,25,66,.379,16,41,.390,9,25,.360,8,15,.533,7,31,38,15,5,3,7,22,67,False,1824,Ohio State
10,School Totals,200,28,62,.452,20,40,.500,8,22,.364,15,18,.833,10,26,36,22,12,4,16,16,79,False,332,Ohio State
10,School Totals,200,24,52,.462,12,26,.462,12,26,.462,10,10,1.000,3,17,20,19,6,1,15,21,70,False,1483,Ohio State
9,School Totals,200,23,58,.397,18,38,.474,5,20,.250,11,14,.786,12,24,36,12,7,2,10,12,62,False,1825,Ohio State
11,School Totals,200,19,49,.388,9,20,.450,10,29,.345,11,16,.688,6,23,29,12,4,0,14,20,59,False,1826,Ohio State
10,School Totals,200,20,49,.408,15,33,.455,5,16,.313,19,29,.655,13,26,39,9,2,2,14,18,64,False,1827,Ohio State
13,School Totals,200,28,57,.491,19,34,.559,9,23,.391,11,22,.500,7,34,41,19,2,4,14,19,76,False,1828,Ohio State
10,School Totals,200,30,50,.600,21,34,.618,9,16,.563,7,12,.583,2,32,34,18,6,6,10,11,76,False,1829,Ohio State
14,School Totals,200,30,66,.455,20,39,.513,10,27,.370,16,19,.842,13,31,44,19,5,9,8,18,86,False,1830,Ohio State
14,School Totals,200,31,58,.534,18,28,.643,13,30,.433,10,14,.714,10,28,38,20,9,5,11,11,85,False,1831,Ohio State
9,School Totals,200,21,48,.438,14,29,.483,7,19,.368,22,30,.733,9,27,36,11,4,1,14,18,71,False,1832,Ohio State
14,School Totals,200,30,63,.476,21,38,.553,9,25,.360,21,26,.808,13,27,40,12,4,2,10,15,90,False,1833,Ohio State
13,School Totals,200,26,56,.464,16,30,.533,10,26,.385,12,15,.800,10,34,44,17,5,4,15,18,74,False,1834,Ohio State
12,School Totals,200,31,54,.574,17,28,.607,14,26,.538,30,37,.811,6,25,31,15,5,2,8,18,106,False,1835,Ohio State
10,School Totals,200,23,60,.383,16,40,.400,7,20,.350,18,23,.783,8,13,21,11,8,3,14,20,71,False,1836,Ohio State
13,School Totals,200,30,51,.588,17,24,.708,13,27,.481,7,12,.583,5,34,39,23,4,6,20,16,80,False,1837,Ohio State
9,School Totals,200,22,44,.500,16,25,.640,6,19,.316,21,27,.778,6,24,30,15,5,7,14,16,71,False,1838,Ohio State
10,School Totals,200,15,48,.313,7,24,.292,8,24,.333,21,29,.724,11,27,38,10,6,2,21,25,59,False,1839,Ohio State
9,School Totals,200,19,47,.404,13,27,.481,6,20,.300,13,17,.765,6,23,29,8,4,1,14,17,57,False,1840,Ohio State
10,School Totals,200,21,67,.313,16,40,.400,5,27,.185,8,10,.800,11,20,31,12,6,4,14,22,55,False,738,Ohio State
11,School Totals,200,17,52,.327,8,26,.308,9,26,.346,11,19,.579,8,22,30,8,3,3,15,24,54,False,351,Ohio State
10,School Totals,200,30,55,.545,20,33,.606,10,22,.455,10,15,.667,7,27,34,17,2,9,12,13,80,False,1841,Ohio State
10,School Totals,200,23,54,.426,14,34,.412,9,20,.450,21,29,.724,5,18,23,14,6,2,12,23,76,False,1842,Ohio State
11,School Totals,200,21,49,.429,16,33,.485,5,16,.313,12,18,.667,7,27,34,9,2,2,12,17,59,False,1843,Ohio State
10,School Totals,200,26,59,.441,15,30,.500,11,29,.379,8,10,.800,10,26,36,16,6,5,11,17,71,False,1844,Ohio State
10,School Totals,200,26,56,.464,16,29,.552,10,27,.370,6,8,.750,9,17,26,19,6,1,10,16,68,False,357,Ohio State
9,School Totals,200,24,57,.421,17,39,.436,7,18,.389,6,10,.600,5,24,29,12,3,3,5,14,61,False,1140,Ohio State
11,School Totals,200,18,49,.367,12,30,.400,6,19,.316,15,16,.938,9,21,30,7,5,4,13,16,57,False,1845,Ohio State
9,School Totals,200,22,51,.431,12,25,.480,10,26,.385,18,21,.857,7,23,30,13,4,2,10,14,72,False,1846,Ohio State
10,School Totals,200,22,45,.489,13,25,.520,9,20,.450,15,23,.652,5,26,31,14,10,0,16,15,68,False,1847,Ohio State
10,School Totals,200,26,62,.419,17,32,.531,9,30,.300,15,18,.833,12,24,36,18,5,3,11,22,76,False,1848,Ohio State
9,School Totals,200,23,54,.426,13,29,.448,10,25,.400,23,28,.821,10,20,30,10,6,0,8,18,79,False,749,Ohio State
11,School Totals,200,25,62,.403,19,37,.514,6,25,.240,19,24,.792,14,32,46,6,5,9,9,17,75,False,1849,Ohio State
8,School Totals,200,27,57,.474,16,36,.444,11,21,.524,12,13,.923,4,26,30,13,4,3,9,12,77,False,1146,Ohio State
11,School Totals,200,22,57,.386,19,42,.452,3,15,.200,24,28,.857,14,21,35,11,9,2,11,13,71,False,1850,Ohio State
8,School Totals,200,24,53,.453,19,37,.514,5,16,.313,16,19,.842,4,22,26,6,5,1,9,18,69,False,1515,Ohio State
14,School Totals,200,31,64,.484,25,46,.543,6,18,.333,26,36,.722,12,26,38,17,8,3,10,16,94,False,1851,Ohio State
10,School Totals,200,22,55,.400,18,37,.486,4,18,.222,26,33,.788,10,26,36,10,6,4,9,18,74,False,1852,Ohio State
12,School Totals,200,27,61,.443,17,35,.486,10,26,.385,13,16,.813,14,26,40,15,7,3,7,15,77,False,1853,Ohio State
11,School Totals,200,29,62,.468,18,39,.462,11,23,.478,21,24,.875,11,18,29,12,8,4,8,17,90,False,1854,Ohio State
11,School Totals,200,21,52,.404,15,31,.484,6,21,.286,19,26,.731,8,22,30,10,3,5,10,12,67,False,1855,Ohio State
10,School Totals,200,22,58,.379,16,34,.471,6,24,.250,10,13,.769,10,19,29,14,6,3,13,18,60,False,1856,Ohio State
12,School Totals,200,25,50,.500,17,28,.607,8,22,.364,19,26,.731,8,20,28,11,2,4,7,19,77,False,1857,Ohio State
12,School Totals,200,27,58,.466,23,39,.590,4,19,.211,22,29,.759,11,31,42,13,2,5,11,20,80,False,1858,Ohio State
12,School Totals,200,27,61,.443,23,41,.561,4,20,.200,12,15,.800,11,29,40,16,3,1,10,15,70,False,1859,Ohio State
13,School Totals,200,31,63,.492,19,31,.613,12,32,.375,16,20,.800,8,31,39,16,3,5,10,18,90,False,1860,Ohio State
12,School Totals,200,19,61,.311,12,34,.353,7,27,.259,15,21,.714,10,22,32,11,1,3,10,19,60,False,1861,Ohio State
12,School Totals,200,25,49,.510,15,25,.600,10,24,.417,19,28,.679,8,30,38,14,3,5,11,14,79,False,1862,Ohio State
11,School Totals,200,27,54,.500,17,29,.586,10,25,.400,17,25,.680,4,33,37,12,1,2,11,18,81,False,1863,Ohio State
11,School Totals,200,29,54,.537,18,33,.545,11,21,.524,18,23,.783,6,21,27,12,6,1,11,20,87,False,1864,Ohio State
11,School Totals,200,20,53,.377,6,18,.333,14,35,.400,11,17,.647,8,18,26,11,2,2,9,18,65,False,1865,Ohio State
11,School Totals,200,27,53,.509,22,37,.595,5,16,.313,15,18,.833,3,28,31,9,6,2,11,16,74,False,1866,Ohio State
12,School Totals,200,28,54,.519,21,32,.656,7,22,.318,20,21,.952,9,24,33,11,6,4,16,20,83,False,1867,Ohio State
12,School Totals,200,25,55,.455,19,37,.514,6,18,.333,23,29,.793,6,27,33,8,6,3,9,24,79,False,1529,Ohio State
12,School Totals,200,31,65,.477,17,33,.515,14,32,.438,13,19,.684,11,31,42,20,4,4,6,19,89,False,1868,Ohio State
12,School Totals,200,25,56,.446,15,30,.500,10,26,.385,13,15,.867,4,23,27,15,7,5,10,20,73,False,772,Ohio State
13,School Totals,200,27,56,.482,20,40,.500,7,16,.438,17,19,.895,12,23,35,10,7,3,10,20,78,False,387,Ohio State
12,School Totals,200,30,53,.566,19,33,.576,11,20,.550,21,26,.808,8,24,32,19,3,5,11,21,92,False,1869,Ohio State
11,School Totals,200,32,60,.533,21,38,.553,11,22,.500,12,13,.923,5,19,24,11,3,1,8,17,87,False,1162,Ohio State
12,School Totals,200,23,52,.442,19,38,.500,4,14,.286,17,23,.739,7,19,26,14,9,2,9,19,67,False,1536,Ohio State
12,School Totals,200,23,51,.451,18,34,.529,5,17,.294,6,10,.600,2,26,28,8,3,2,12,13,57,False,1870,Ohio State
10,School Totals,200,26,65,.400,17,36,.472,9,29,.310,7,11,.636,11,20,31,10,4,5,9,24,68,False,1871,Ohio State
11,School Totals,200,28,56,.500,24,44,.545,4,12,.333,19,28,.679,6,28,34,19,6,4,15,17,79,False,1872,Ohio State
11,School Totals,225,30,66,.455,19,35,.543,11,31,.355,16,18,.889,10,27,37,19,6,2,9,22,87,False,1873,Ohio State
12,School Totals,200,24,57,.421,12,35,.343,12,22,.545,8,14,.571,9,27,36,13,0,7,8,19,68,False,1167,Ohio State
11,School Totals,225,29,65,.446,21,40,.525,8,25,.320,22,30,.733,8,27,35,11,7,4,8,26,88,False,1874,Ohio State
10,School Totals,225,29,67,.433,24,44,.545,5,23,.217,9,18,.500,10,34,44,15,2,5,16,17,72,False,1875,Ohio State
12,School Totals,200,26,54,.481,17,27,.630,9,27,.333,9,17,.529,8,24,32,11,3,1,10,23,70,False,1876,Penn State
13,School Totals,200,28,54,.519,16,28,.571,12,26,.462,12,18,.667,11,26,37,16,2,2,13,15,80,False,1877,Penn State
10,School Totals,200,21,65,.323,16,44,.364,5,21,.238,22,27,.815,12,18,30,12,9,0,5,19,69,False,1878,Penn State
11,School Totals,200,17,55,.309,13,37,.351,4,18,.222,22,25,.880,11,23,34,7,1,1,11,22,60,False,1879,Penn State
10,School Totals,200,21,53,.396,16,34,.471,5,19,.263,12,15,.800,7,21,28,11,8,0,12,13,59,False,1880,Penn State
11,School Totals,200,30,47,.638,24,34,.706,6,13,.462,21,25,.840,2,19,21,21,9,0,11,14,87,False,1881,Penn State
10,School Totals,200,23,52,.442,17,35,.486,6,17,.353,17,25,.680,8,26,34,12,4,3,10,17,69,False,1882,Penn State
10,School Totals,200,15,43,.349,10,24,.417,5,19,.263,7,9,.778,4,26,30,7,2,5,14,13,42,False,1883,Penn State
13,School Totals,200,25,64,.391,21,43,.488,4,21,.190,4,7,.571,14,34,48,14,4,3,14,7,58,False,1884,Penn State
10,School Totals,200,22,65,.338,15,41,.366,7,24,.292,13,22,.591,15,24,39,11,3,3,6,21,64,False,1885,Penn State
13,School Totals,200,32,60,.533,20,34,.588,12,26,.462,28,32,.875,9,32,41,22,11,0,11,11,104,False,1886,Penn State
14,School Totals,200,28,51,.549,19,34,.559,9,17,.529,11,20,.550,11,24,35,15,6,2,13,11,76,False,1887,Penn State
9,School Totals,200,26,54,.481,17,36,.472,9,18,.500,9,13,.692,6,19,25,19,4,0,14,16,70,False,1888,Penn State
11,School Totals,200,17,49,.347,12,30,.400,5,19,.263,7,19,.368,8,24,32,11,4,0,10,15,46,False,1889,Penn State
10,School Totals,200,22,45,.489,16,31,.516,6,14,.429,5,8,.625,7,16,23,13,7,1,17,13,55,False,796,Penn State
10,School Totals,200,20,58,.345,12,30,.400,8,28,.286,5,9,.556,10,25,35,11,6,4,11,13,53,False,1890,Penn State
10,School Totals,200,22,52,.423,19,36,.528,3,16,.188,17,23,.739,9,22,31,9,5,2,8,21,64,False,1891,Penn State
10,School Totals,200,23,62,.371,19,40,.475,4,22,.182,11,18,.611,16,23,39,12,4,2,13,13,61,False,17,Penn State
10,School Totals,225,29,56,.518,22,41,.537,7,15,.467,6,8,.750,6,27,33,13,1,1,18,17,71,False,1892,Penn State
11,School Totals,200,23,57,.404,14,31,.452,9,26,.346,12,22,.545,7,19,26,15,5,1,5,20,67,False,1893,Penn State
13,School Totals,200,15,48,.313,12,31,.387,3,17,.176,13,15,.867,7,24,31,8,4,1,10,18,46,False,1894,Penn State
10,School Totals,200,23,48,.479,19,35,.543,4,13,.308,12,15,.800,4,20,24,14,0,0,10,21,62,False,1558,Penn State
10,School Totals,200,21,52,.404,12,28,.429,9,24,.375,13,20,.650,6,17,23,13,8,0,11,18,64,False,1895,Penn State
11,School Totals,200,18,44,.409,7,18,.389,11,26,.423,7,12,.583,3,20,23,12,3,5,8,14,54,False,1196,Penn State
10,School Totals,200,27,48,.563,20,31,.645,7,17,.412,20,23,.870,5,27,32,21,3,3,14,17,81,False,1896,Penn State
9,School Totals,200,24,49,.490,19,36,.528,5,13,.385,2,5,.400,6,27,33,12,3,2,13,12,55,False,807,Penn State
9,School Totals,200,24,54,.444,19,37,.514,5,17,.294,14,19,.737,8,21,29,14,3,2,10,19,67,False,1562,Penn State
13,School Totals,200,28,49,.571,21,36,.583,7,13,.538,16,24,.667,7,25,32,15,6,7,9,22,79,False,1897,Penn State
11,School Totals,200,23,50,.460,14,27,.519,9,23,.391,10,15,.667,5,19,24,17,5,1,9,15,65,False,1199,Penn State
11,School Totals,200,20,49,.408,11,27,.407,9,22,.409,11,14,.786,7,20,27,12,5,1,15,15,60,False,1898,Penn State
10,School Totals,200,18,46,.391,14,30,.467,4,16,.250,15,18,.833,7,17,24,10,5,1,14,17,55,False,1899,Penn State
13,School Totals,200,25,62,.403,19,40,.475,6,22,.273,14,17,.824,16,26,42,11,4,6,11,15,70,False,1900,Penn State
9,School Totals,200,20,55,.364,19,34,.559,1,21,.048,25,34,.735,12,27,39,9,7,3,16,17,66,False,1901,Penn State
12,School Totals,200,25,61,.410,16,39,.410,9,22,.409,5,8,.625,12,26,38,14,5,5,12,12,64,False,1902,Penn State
12,School Totals,200,29,56,.518,24,40,.600,5,16,.313,14,15,.933,6,20,26,13,6,2,10,15,77,False,1903,Penn State
8,School Totals,200,23,52,.442,15,35,.429,8,17,.471,17,23,.739,9,14,23,17,2,2,9,17,71,False,1904,Penn State
12,School Totals,200,26,48,.542,14,29,.483,12,19,.632,6,9,.667,9,21,30,16,9,2,14,12,70,False,1905,Penn State
10,School Totals,200,14,68,.206,11,41,.268,3,27,.111,8,11,.727,16,20,36,6,3,5,12,16,39,False,434,Penn State
12,School Totals,200,28,51,.549,23,41,.561,5,10,.500,16,31,.516,6,27,33,13,8,2,14,20,77,False,1906,Penn State
9,School Totals,200,21,50,.420,17,38,.447,4,12,.333,11,18,.611,12,23,35,10,2,5,15,11,57,False,1907,Penn State
10,School Totals,200,24,57,.421,17,35,.486,7,22,.318,14,16,.875,9,20,29,10,2,2,9,18,69,False,1908,Penn State
11,School Totals,200,22,57,.386,15,34,.441,7,23,.304,13,18,.722,11,14,25,12,9,1,13,26,64,False,1909,Penn State
8,School Totals,200,21,39,.538,13,22,.591,8,17,.471,19,26,.731,6,21,27,9,5,4,12,15,69,False,44,Penn State
8,School Totals,200,25,54,.463,18,33,.545,7,21,.333,12,18,.667,8,16,24,17,1,0,6,15,69,False,827,Penn State
10,School Totals,200,25,61,.410,20,43,.465,5,18,.278,13,20,.650,6,22,28,15,9,3,11,28,68,False,1910,Penn State
9,School Totals,200,23,57,.404,18,40,.450,5,17,.294,15,23,.652,14,21,35,13,4,5,5,19,66,False,1219,Penn State
9,School Totals,200,18,52,.346,11,28,.393,7,24,.292,14,14,1.000,10,23,33,12,9,3,9,12,57,False,1911,Penn State
9,School Totals,200,25,45,.556,21,28,.750,4,17,.235,12,13,.923,7,18,25,15,3,0,14,16,66,False,1584,Penn State
9,School Totals,200,24,46,.522,18,30,.600,6,16,.375,8,8,1.000,7,19,26,16,0,4,13,13,62,False,1912,Penn State
10,School Totals,200,25,47,.532,20,31,.645,5,16,.313,10,11,.909,7,17,24,14,3,4,14,15,65,False,1913,Penn State
9,School Totals,200,19,40,.475,13,23,.565,6,17,.353,12,20,.600,8,21,29,7,5,2,10,10,56,False,1914,Penn State
11,School Totals,200,17,51,.333,15,34,.441,2,17,.118,15,21,.714,7,20,27,9,3,0,6,14,51,False,1915,Penn State
9,School Totals,200,19,47,.404,9,19,.474,10,28,.357,14,17,.824,8,20,28,14,3,1,7,16,62,False,836,Penn State
11,School Totals,200,23,56,.411,16,38,.421,7,18,.389,4,11,.364,9,11,20,12,4,1,6,28,57,False,1226,Penn State
11,School Totals,200,21,43,.488,16,29,.552,5,14,.357,18,23,.783,3,28,31,13,5,2,8,9,65,False,1916,Penn State
11,School Totals,200,22,51,.431,10,20,.500,12,31,.387,10,16,.625,7,13,20,15,4,3,5,16,66,False,1917,Penn State
10,School Totals,200,26,49,.531,15,27,.556,11,22,.500,3,5,.600,4,15,19,11,4,0,10,18,66,False,1918,Penn State
9,School Totals,200,26,46,.565,22,32,.688,4,14,.286,10,12,.833,6,22,28,19,3,1,12,12,66,False,1919,Penn State
11,School Totals,200,24,49,.490,20,36,.556,4,13,.308,9,15,.600,5,13,18,10,6,1,13,16,61,False,1593,Penn State
8,School Totals,200,23,51,.451,15,31,.484,8,20,.400,12,12,1.000,8,19,27,11,5,3,11,13,66,False,1920,Penn State
10,School Totals,200,22,48,.458,16,32,.500,6,16,.375,11,20,.550,11,17,28,11,4,1,11,10,61,False,62,Penn State
8,School Totals,200,13,39,.333,10,27,.370,3,12,.250,7,8,.875,6,20,26,8,2,1,7,14,36,False,1921,Penn State
9,School Totals,200,21,50,.420,12,28,.429,9,22,.409,10,16,.625,8,28,36,11,5,6,6,12,61,False,1234,Penn State
9,School Totals,200,22,56,.393,15,38,.395,7,18,.389,9,9,1.000,5,20,25,8,3,2,8,17,60,False,1596,Penn State
8,School Totals,200,26,54,.481,18,35,.514,8,19,.421,4,6,.667,8,17,25,12,4,0,9,13,64,False,1922,Penn State
11,School Totals,200,23,64,.359,13,41,.317,10,23,.435,14,26,.538,14,22,36,13,15,1,13,22,70,False,1923,Penn State
13,School Totals,200,24,53,.453,17,28,.607,7,25,.280,7,12,.583,14,21,35,11,7,4,12,15,62,False,1924,Penn State
11,School Totals,200,27,65,.415,18,38,.474,9,27,.333,14,18,.778,14,21,35,17,8,5,8,24,77,False,1925,Penn State
13,School Totals,200,18,67,.269,11,40,.275,7,27,.259,4,12,.333,18,21,39,9,4,3,12,22,47,False,1926,Penn State
11,School Totals,200,17,45,.378,12,25,.480,5,20,.250,14,21,.667,9,18,27,5,12,1,14,19,53,False,1927,Penn State
10,School Totals,200,26,46,.565,15,24,.625,11,22,.500,19,31,.613,9,23,32,15,7,3,18,11,82,False,1928,Penn State
12,School Totals,200,19,71,.268,12,43,.279,7,28,.250,2,7,.286,13,23,36,11,6,3,11,20,47,False,1929,Penn State
11,School Totals,200,21,54,.389,14,30,.467,7,24,.292,13,20,.650,10,24,34,7,7,2,14,23,62,False,1930,Penn State
9,School Totals,200,26,54,.481,20,35,.571,6,19,.316,12,19,.632,10,20,30,16,2,1,15,13,70,False,1931,Penn State
9,School Totals,200,19,58,.328,16,35,.457,3,23,.130,16,26,.615,18,26,44,14,6,1,13,18,57,False,1932,Penn State
11,School Totals,200,21,49,.429,17,33,.515,4,16,.250,13,16,.813,8,27,35,13,3,3,23,21,59,False,1933,Penn State
13,School Totals,200,27,53,.509,19,33,.576,8,20,.400,10,13,.769,9,22,31,14,9,3,11,15,72,False,1934,Penn State
9,School Totals,200,21,56,.375,11,32,.344,10,24,.417,22,30,.733,15,22,37,10,9,5,12,13,74,False,1935,Penn State
10,School Totals,200,21,53,.396,17,38,.447,4,15,.267,7,12,.583,8,20,28,6,4,1,13,17,53,False,859,Penn State
10,School Totals,200,18,53,.340,12,34,.353,6,19,.316,14,23,.609,15,17,32,11,8,0,15,23,56,False,1936,Penn State
13,School Totals,200,24,55,.436,14,34,.412,10,21,.476,7,10,.700,10,25,35,16,7,1,10,16,65,False,1937,Penn State
10,School Totals,200,27,59,.458,20,36,.556,7,23,.304,21,25,.840,9,19,28,13,8,3,9,26,82,False,78,Penn State
11,School Totals,200,20,60,.333,17,36,.472,3,24,.125,15,19,.789,12,20,32,5,9,3,13,21,58,False,1938,Penn State
11,School Totals,200,18,60,.300,11,36,.306,7,24,.292,23,28,.821,15,16,31,7,11,2,11,29,66,False,1939,Penn State
9,School Totals,200,20,49,.408,16,39,.410,4,10,.400,10,13,.769,10,18,28,14,6,5,12,16,54,False,1940,Penn State
9,School Totals,200,17,50,.340,13,33,.394,4,17,.235,16,23,.696,10,13,23,5,1,2,8,23,54,False,82,Penn State
10,School Totals,200,20,64,.313,15,48,.313,5,16,.313,9,16,.563,11,20,31,7,4,2,10,26,54,False,1618,Penn State
9,School Totals,200,18,50,.360,16,40,.400,2,10,.200,8,14,.571,9,23,32,9,3,2,9,20,46,False,1941,Penn State
10,School Totals,200,25,62,.403,15,33,.455,10,29,.345,4,7,.571,8,21,29,12,6,2,15,26,64,False,1942,Penn State
10,School Totals,200,20,52,.385,14,32,.438,6,20,.300,11,16,.688,5,17,22,11,4,3,13,26,57,False,1256,Penn State
12,School Totals,200,23,44,.523,14,21,.667,9,23,.391,12,14,.857,4,25,29,13,8,2,13,15,67,False,1943,Penn State
10,School Totals,200,21,53,.396,16,36,.444,5,17,.294,22,28,.786,11,20,31,11,7,3,8,22,69,False,1944,Penn State
9,School Totals,200,22,56,.393,18,38,.474,4,18,.222,7,11,.636,7,17,24,8,7,2,5,15,55,False,1945,Penn State
10,School Totals,200,29,57,.509,26,43,.605,3,14,.214,5,9,.556,12,24,36,15,5,0,12,15,66,False,1946,Penn State
12,School Totals,200,22,48,.458,18,30,.600,4,18,.222,8,10,.800,4,11,15,10,9,0,12,19,56,False,1947,Penn State
9,School Totals,200,22,55,.400,16,41,.390,6,14,.429,15,18,.833,15,15,30,8,8,1,11,15,65,False,875,Penn State
12,School Totals,200,19,55,.345,11,38,.289,8,17,.471,12,16,.750,9,18,27,8,8,8,9,28,58,False,94,Penn State
10,School Totals,200,17,47,.362,14,23,.609,3,24,.125,28,32,.875,12,24,36,8,6,3,17,23,65,False,1948,Penn State
10,School Totals,200,19,60,.317,16,41,.390,3,19,.158,14,17,.824,13,21,34,4,8,1,13,18,55,False,1949,Penn State
9,School Totals,225,20,53,.377,16,32,.500,4,21,.190,11,19,.579,15,18,33,10,11,3,16,21,55,False,1950,Penn State
13,School Totals,200,20,55,.364,13,34,.382,7,21,.333,13,20,.650,13,13,26,8,5,1,13,24,60,False,1951,Penn State
9,School Totals,200,22,57,.386,15,38,.395,7,19,.368,9,20,.450,11,22,33,9,8,3,7,19,60,False,1952,Penn State
10,School Totals,200,19,53,.358,13,33,.394,6,20,.300,17,25,.680,8,24,32,6,6,5,13,26,61,False,1953,Penn State
10,School Totals,200,18,45,.400,13,29,.448,5,16,.313,17,23,.739,8,23,31,8,6,5,13,19,58,False,1954,Penn State
10,School Totals,200,22,50,.440,19,38,.500,3,12,.250,10,17,.588,10,24,34,11,2,0,11,20,57,False,1955,Penn State
11,School Totals,200,29,57,.509,22,38,.579,7,19,.368,13,20,.650,9,27,36,13,7,3,16,21,78,False,1956,Penn State
11,School Totals,225,26,53,.491,19,35,.543,7,18,.389,21,31,.677,6,31,37,15,2,5,11,21,80,False,1957,Penn State
13,School Totals,200,25,54,.463,18,32,.563,7,22,.318,15,22,.682,6,28,34,13,8,4,7,17,72,False,1958,Penn State
11,School Totals,200,25,59,.424,17,39,.436,8,20,.400,26,36,.722,14,32,46,12,1,4,15,26,84,False,1959,Penn State
9,School Totals,200,24,52,.462,21,44,.477,3,8,.375,0,1,.000,6,25,31,7,2,2,15,23,51,False,1960,Penn State
12,School Totals,200,19,60,.317,14,42,.333,5,18,.278,8,11,.727,13,17,30,10,4,4,19,25,51,False,113,Penn State
12,School Totals,200,18,57,.316,15,42,.357,3,15,.200,15,18,.833,12,20,32,7,2,3,11,23,54,False,1961,Penn State
13,School Totals,200,15,58,.259,12,46,.261,3,12,.250,9,12,.750,11,18,29,8,8,6,14,18,42,False,1962,Penn State
10,School Totals,200,24,50,.480,19,34,.559,5,16,.313,19,27,.704,3,25,28,9,4,1,7,23,72,False,1286,Penn State
11,School Totals,200,22,57,.386,17,37,.459,5,20,.250,15,24,.625,11,21,32,10,5,3,14,17,64,False,1963,Penn State
13,School Totals,200,17,51,.333,15,36,.417,2,15,.133,13,18,.722,7,20,27,5,7,7,16,29,49,False,117,Penn State
11,School Totals,200,17,47,.362,13,30,.433,4,17,.235,13,22,.591,2,23,25,11,3,7,4,19,51,False,1647,Penn State
11,School Totals,200,23,58,.397,16,35,.457,7,23,.304,14,16,.875,8,19,27,10,8,4,17,26,67,False,1964,Penn State
10,School Totals,200,19,62,.306,17,42,.405,2,20,.100,9,13,.692,10,25,35,10,4,1,8,24,49,False,1965,Penn State
12,School Totals,200,14,48,.292,12,38,.316,2,10,.200,23,32,.719,10,25,35,3,5,1,13,28,53,False,1966,Penn State
10,School Totals,200,27,61,.443,19,44,.432,8,17,.471,10,15,.667,7,17,24,17,7,4,6,19,72,False,1967,Penn State
10,School Totals,200,25,57,.439,19,39,.487,6,18,.333,15,17,.882,9,24,33,15,2,1,12,25,71,False,903,Penn State
11,School Totals,200,21,48,.438,13,29,.448,8,19,.421,9,16,.563,10,19,29,11,4,2,15,31,59,False,1968,Penn State
8,School Totals,200,27,57,.474,17,37,.459,10,20,.500,20,27,.741,9,18,27,15,9,3,9,17,84,False,905,Penn State
11,School Totals,200,13,48,.271,10,34,.294,3,14,.214,15,23,.652,2,18,20,9,4,5,9,24,44,False,1969,Penn State
11,School Totals,200,22,45,.489,15,28,.536,7,17,.412,15,25,.600,8,22,30,12,10,3,16,17,66,False,1970,Penn State
10,School Totals,200,23,53,.434,20,44,.455,3,9,.333,11,14,.786,6,23,29,7,3,2,6,19,60,False,1971,Penn State
10,School Totals,200,29,60,.483,26,52,.500,3,8,.375,5,8,.625,9,19,28,12,3,4,8,16,66,False,908,Penn State
10,School Totals,200,19,53,.358,13,37,.351,6,16,.375,30,43,.698,7,36,43,10,3,5,6,22,74,False,1972,Penn State
10,School Totals,200,28,57,.491,19,35,.543,9,22,.409,15,23,.652,6,16,22,11,6,1,7,24,80,False,1973,Penn State
13,School Totals,200,29,54,.537,22,34,.647,7,20,.350,18,23,.783,6,24,30,13,4,2,14,28,83,False,1974,Penn State
9,School Totals,200,29,62,.468,20,40,.500,9,22,.409,12,14,.857,10,21,31,18,3,7,8,14,79,False,1975,Penn State
13,School Totals,200,32,56,.571,23,32,.719,9,24,.375,20,25,.800,12,22,34,25,5,3,11,20,93,False,1976,Penn State
13,School Totals,200,28,52,.538,19,28,.679,9,24,.375,19,24,.792,10,24,34,17,5,1,11,19,84,False,1977,Penn State
10,School Totals,225,25,62,.403,15,37,.405,10,25,.400,29,38,.763,8,30,38,10,7,3,4,19,89,False,1978,Penn State
9,School Totals,200,28,59,.475,19,37,.514,9,22,.409,11,18,.611,9,26,35,15,5,6,9,15,76,False,1979,Penn State
11,School Totals,200,23,55,.418,19,40,.475,4,15,.267,19,23,.826,4,23,27,9,3,5,8,26,69,False,1980,Penn State
12,School Totals,200,33,68,.485,26,44,.591,7,24,.292,17,21,.810,10,31,41,20,6,10,11,19,90,False,1981,Penn State
10,School Totals,200,26,61,.426,17,36,.472,9,25,.360,7,10,.700,9,29,38,18,3,13,11,25,68,False,1982,Penn State
10,School Totals,225,29,58,.500,25,44,.568,4,14,.286,17,23,.739,5,35,40,10,3,3,20,20,79,False,1983,Penn State
10,School Totals,200,33,62,.532,31,51,.608,2,11,.182,24,30,.800,10,22,32,11,6,4,10,16,92,False,1984,Penn State
10,School Totals,200,20,52,.385,11,31,.355,9,21,.429,14,22,.636,6,19,25,8,6,7,12,14,63,False,1313,Penn State
13,School Totals,200,17,57,.298,12,38,.316,5,19,.263,16,22,.727,9,22,31,3,5,7,11,26,55,False,1985,Penn State
11,School Totals,200,22,58,.379,19,39,.487,3,19,.158,18,29,.621,13,24,37,10,4,7,14,28,65,False,1986,Penn State
11,School Totals,200,24,55,.436,16,32,.500,8,23,.348,20,26,.769,9,18,27,10,3,4,12,28,76,False,150,Penn State
10,School Totals,200,26,53,.491,21,34,.618,5,19,.263,10,13,.769,7,17,24,8,2,2,9,17,67,False,931,Penn State
10,School Totals,200,22,60,.367,15,34,.441,7,26,.269,13,18,.722,8,23,31,11,6,9,11,24,64,False,1987,Penn State
11,School Totals,200,20,57,.351,15,36,.417,5,21,.238,13,17,.765,9,22,31,9,6,4,5,12,58,False,1988,Penn State
10,School Totals,225,28,58,.483,19,33,.576,9,25,.360,6,9,.667,8,23,31,10,2,8,13,19,71,False,1679,Penn State
11,School Totals,200,24,58,.414,19,38,.500,5,20,.250,26,34,.765,14,24,38,9,2,4,12,22,79,False,1989,Penn State
12,School Totals,200,21,57,.368,16,35,.457,5,22,.227,20,23,.870,7,20,27,10,5,2,7,15,67,False,1320,Penn State
10,School Totals,200,21,55,.382,16,37,.432,5,18,.278,8,11,.727,9,23,32,9,2,1,6,20,55,False,1990,Penn State
11,School Totals,200,22,54,.407,14,35,.400,8,19,.421,14,18,.778,8,13,21,13,11,1,15,22,66,False,158,Penn State
10,School Totals,200,26,65,.400,23,49,.469,3,16,.188,15,21,.714,13,20,33,9,3,5,9,23,70,False,1991,Penn State
13,School Totals,200,22,63,.349,16,45,.356,6,18,.333,17,23,.739,13,20,33,8,5,4,5,27,67,False,1992,Penn State
11,School Totals,200,19,43,.442,14,30,.467,5,13,.385,22,28,.786,6,24,30,11,3,5,14,24,65,False,1686,Penn State
9,School Totals,201,28,58,.483,27,45,.600,1,13,.077,9,13,.692,11,23,34,9,3,3,11,20,66,False,1993,Penn State
13,School Totals,200,24,48,.500,18,33,.545,6,15,.400,5,13,.385,6,28,34,15,8,5,10,20,59,False,1994,Penn State
12,School Totals,200,19,47,.404,14,34,.412,5,13,.385,20,23,.870,8,18,26,10,5,2,15,22,63,False,1995,Penn State
10,School Totals,200,19,59,.322,14,38,.368,5,21,.238,13,14,.929,11,22,33,10,4,6,9,19,56,False,1996,Penn State
11,School Totals,200,17,42,.405,12,25,.480,5,17,.294,30,40,.750,10,29,39,6,4,5,13,22,69,False,1997,Penn State
10,School Totals,200,17,57,.298,11,40,.275,6,17,.353,12,22,.545,9,21,30,9,6,5,9,20,52,False,1998,Penn State
11,School Totals,200,21,48,.438,16,35,.457,5,13,.385,14,23,.609,12,25,37,10,5,4,18,17,61,False,1999,Penn State
14,School Totals,200,25,53,.472,18,35,.514,7,18,.389,16,25,.640,6,29,35,13,7,2,14,18,73,False,2000,Penn State
12,School Totals,250,32,82,.390,21,48,.438,11,34,.324,22,28,.786,14,28,42,13,8,2,11,34,97,False,2001,Penn State
11,School Totals,200,26,57,.456,19,36,.528,7,21,.333,13,17,.765,11,21,32,7,9,4,10,17,72,False,2002,Penn State
11,School Totals,200,25,59,.424,18,37,.486,7,22,.318,6,10,.600,10,18,28,10,3,5,15,19,63,False,2003,Penn State
10,School Totals,200,26,57,.456,19,38,.500,7,19,.368,19,26,.731,10,26,36,13,4,9,12,15,78,False,2004,Penn State
10,School Totals,200,30,54,.556,22,39,.564,8,15,.533,20,26,.769,9,22,31,6,6,4,13,23,88,False,2005,Penn State
11,School Totals,200,20,54,.370,16,30,.533,4,24,.167,17,30,.567,14,33,47,4,4,4,17,18,61,False,2006,Penn State
11,School Totals,200,23,55,.418,17,35,.486,6,20,.300,21,32,.656,10,32,42,13,7,1,13,26,73,False,2007,Penn State
11,School Totals,200,20,53,.377,16,34,.471,4,19,.211,20,28,.714,10,21,31,8,6,5,11,20,64,False,2008,Penn State
11,School Totals,200,24,62,.387,17,38,.447,7,24,.292,9,9,1.000,15,23,38,11,7,11,10,20,64,False,2009,Penn State
11,School Totals,200,23,47,.489,16,30,.533,7,17,.412,20,27,.741,5,29,34,9,6,4,12,22,73,False,2010,Penn State
14,School Totals,200,23,49,.469,16,30,.533,7,19,.368,16,24,.667,7,27,34,15,5,4,11,15,69,False,2011,Penn State
14,School Totals,200,29,54,.537,24,42,.571,5,12,.417,9,14,.643,5,15,20,7,5,0,9,23,72,False,2012,Penn State
11,School Totals,200,15,52,.288,10,25,.400,5,27,.185,11,17,.647,6,26,32,8,7,1,11,20,46,False,2013,Penn State
10,School Totals,200,22,53,.415,15,33,.455,7,20,.350,13,18,.722,6,16,22,11,5,4,9,20,64,False,965,Penn State
10,School Totals,200,31,66,.470,27,42,.643,4,24,.167,7,11,.636,11,23,34,14,8,3,9,18,73,False,183,Penn State
11,School Totals,225,26,56,.464,18,38,.474,8,18,.444,17,21,.810,9,18,27,9,7,3,17,25,77,False,2014,Penn State
11,School Totals,200,20,47,.426,13,28,.464,7,19,.368,13,22,.591,7,17,24,7,7,0,12,24,60,False,1349,Penn State
13,School Totals,200,29,57,.509,19,37,.514,10,20,.500,11,15,.733,9,22,31,18,8,1,8,15,79,False,2015,Penn State
10,School Totals,200,21,50,.420,16,36,.444,5,14,.357,16,21,.762,8,24,32,14,10,9,14,12,63,False,2016,Penn State
10,School Totals,200,19,45,.422,15,29,.517,4,16,.250,16,19,.842,10,21,31,4,5,3,19,20,58,False,2017,Penn State
11,School Totals,200,22,57,.386,16,35,.457,6,22,.273,8,13,.615,6,21,27,8,3,3,10,20,58,False,583,Penn State
12,School Totals,200,19,44,.432,10,23,.435,9,21,.429,9,14,.643,6,29,35,11,5,2,16,14,56,False,2018,Penn State
12,School Totals,200,19,59,.322,13,42,.310,6,17,.353,11,18,.611,11,22,33,7,1,3,13,22,55,False,1710,Penn State
10,School Totals,200,25,60,.417,16,37,.432,9,23,.391,14,19,.737,7,23,30,11,6,4,7,21,73,False,585,Penn State
11,School Totals,200,21,54,.389,19,41,.463,2,13,.154,3,3,1.000,4,24,28,5,5,3,6,17,47,False,2019,Penn State
13,School Totals,200,15,55,.273,7,28,.250,8,27,.296,1,8,.125,13,21,34,11,4,6,14,15,39,False,2020,Penn State
11,School Totals,225,27,69,.391,17,41,.415,10,28,.357,13,20,.650,15,27,42,15,9,7,15,23,77,False,2021,Penn State
13,School Totals,200,22,52,.423,19,35,.543,3,17,.176,20,24,.833,4,22,26,9,6,3,11,28,67,False,1713,Penn State
10,School Totals,200,31,66,.470,21,42,.500,10,24,.417,7,10,.700,11,23,34,10,5,4,9,20,79,False,2022,Penn State
10,School Totals,200,23,55,.418,14,33,.424,9,22,.409,13,22,.591,3,26,29,8,8,16,12,24,68,False,2023,Penn State
11,School Totals,200,22,56,.393,16,41,.390,6,15,.400,17,24,.708,8,22,30,11,9,3,5,22,67,False,2024,Penn State
11,School Totals,200,19,56,.339,12,41,.293,7,15,.467,14,18,.778,10,15,25,6,6,1,3,24,59,False,2025,Penn State
11,School Totals,200,23,54,.426,18,35,.514,5,19,.263,11,18,.611,13,24,37,4,6,5,9,16,62,False,2026,Penn State
10,School Totals,200,22,54,.407,12,33,.364,10,21,.476,14,20,.700,6,20,26,12,7,5,10,18,68,False,2027,Penn State
11,School Totals,200,19,64,.297,14,43,.326,5,21,.238,9,17,.529,13,21,34,6,6,3,14,18,52,False,2028,Penn State
10,School Totals,200,28,60,.467,22,38,.579,6,22,.273,12,21,.571,8,19,27,13,5,2,5,21,74,False,2029,Penn State
10,School Totals,200,21,53,.396,16,35,.457,5,18,.278,15,22,.682,9,27,36,9,5,7,9,19,62,False,2030,Penn State
11,School Totals,200,22,51,.431,12,29,.414,10,22,.455,13,19,.684,9,29,38,12,5,5,9,22,67,False,2031,Penn State
11,School Totals,200,22,61,.361,13,40,.325,9,21,.429,28,38,.737,16,29,45,13,4,0,15,25,81,False,2032,Penn State
11,School Totals,200,25,59,.424,18,33,.545,7,26,.269,9,16,.563,9,26,35,9,5,4,11,22,66,False,2033,Penn State
10,School Totals,200,28,50,.560,25,38,.658,3,12,.250,22,26,.846,10,25,35,16,5,7,21,20,81,False,2034,Penn State
11,School Totals,200,18,55,.327,15,35,.429,3,20,.150,15,25,.600,11,17,28,8,6,12,8,11,54,False,2035,Penn State
10,School Totals,200,23,59,.390,19,45,.422,4,14,.286,13,17,.765,10,25,35,6,7,6,8,16,63,False,2036,Penn State
11,School Totals,200,25,59,.424,18,40,.450,7,19,.368,13,16,.813,6,18,24,7,7,2,7,27,70,False,2037,Penn State
10,School Totals,200,29,59,.492,26,44,.591,3,15,.200,14,25,.560,14,21,35,8,6,6,14,23,75,False,2038,Penn State
10,School Totals,200,23,53,.434,18,34,.529,5,19,.263,13,16,.813,6,21,27,7,2,4,11,26,64,False,606,Penn State
11,School Totals,200,19,54,.352,15,36,.417,4,18,.222,14,16,.875,8,19,27,8,4,5,11,10,56,False,995,Penn State
10,School Totals,200,28,55,.509,21,34,.618,7,21,.333,23,31,.742,8,17,25,15,8,2,9,18,86,False,2039,Penn State
11,School Totals,200,21,51,.412,18,37,.486,3,14,.214,20,28,.714,7,24,31,5,3,5,13,17,65,False,1382,Penn State
10,School Totals,200,24,54,.444,19,35,.543,5,19,.263,4,8,.500,3,20,23,8,5,0,11,21,57,False,2040,Penn State
11,School Totals,200,19,44,.432,10,23,.435,9,21,.429,24,33,.727,6,32,38,14,2,5,12,18,71,False,2041,Penn State
10,School Totals,200,17,44,.386,11,29,.379,6,15,.400,20,27,.741,8,24,32,9,3,4,13,29,60,False,2042,Penn State
10,School Totals,200,20,60,.333,16,35,.457,4,25,.160,2,5,.400,5,24,29,10,4,3,11,15,46,False,1736,Penn State
10,School Totals,200,26,62,.419,17,33,.515,9,29,.310,11,15,.733,10,19,29,13,3,4,8,23,72,False,1001,Penn State
10,School Totals,200,21,69,.304,20,49,.408,1,20,.050,6,12,.500,14,21,35,8,7,6,10,23,49,False,2043,Penn State
11,School Totals,200,25,60,.417,17,36,.472,8,24,.333,10,16,.625,8,20,28,11,8,2,6,22,68,False,224,Penn State
12,School Totals,200,21,55,.382,15,32,.469,6,23,.261,6,9,.667,13,20,33,9,6,4,16,15,54,False,2044,Penn State
10,School Totals,200,26,56,.464,16,28,.571,10,28,.357,17,22,.773,11,23,34,15,6,5,14,26,79,False,2045,Penn State
11,School Totals,200,25,65,.385,16,43,.372,9,22,.409,11,14,.786,13,29,42,9,5,4,10,19,70,False,2046,Penn State
9,School Totals,200,20,51,.392,9,26,.346,11,25,.440,5,7,.714,6,22,28,11,4,3,12,17,56,False,2047,Penn State
11,School Totals,200,19,59,.322,10,37,.270,9,22,.409,10,19,.526,6,23,29,9,3,5,6,20,57,False,1391,Penn State
11,School Totals,200,21,52,.404,12,27,.444,9,25,.360,10,12,.833,8,21,29,17,6,5,13,20,61,False,2048,Penn State
10,School Totals,250,26,58,.448,16,35,.457,10,23,.435,24,30,.800,5,30,35,11,8,8,12,20,86,False,2049,Penn State
10,School Totals,200,26,59,.441,17,37,.459,9,22,.409,14,21,.667,8,21,29,10,5,3,10,27,75,False,1743,Penn State
10,School Totals,200,27,63,.429,18,38,.474,9,25,.360,18,22,.818,3,19,22,9,7,8,12,23,81,False,2050,Penn State
10,School Totals,200,28,58,.483,21,37,.568,7,21,.333,19,23,.826,6,24,30,20,6,10,13,20,82,False,2051,Penn State
9,School Totals,200,32,69,.464,24,50,.480,8,19,.421,13,16,.813,11,24,35,20,9,6,11,20,85,False,2052,Penn State
10,School Totals,200,28,64,.438,22,43,.512,6,21,.286,6,11,.545,9,24,33,12,3,3,14,23,68,False,2053,Penn State
11,School Totals,200,17,47,.362,12,27,.444,5,20,.250,11,12,.917,2,20,22,5,4,4,18,15,50,False,2054,Penn State
10,School Totals,200,22,65,.338,11,39,.282,11,26,.423,17,21,.810,14,25,39,14,6,3,9,13,72,False,2055,Penn State
10,School Totals,200,25,60,.417,20,47,.426,5,13,.385,19,22,.864,8,29,37,17,6,7,14,16,74,False,2056,Penn State
9,School Totals,200,26,61,.426,22,46,.478,4,15,.267,11,15,.733,10,26,36,14,11,8,11,11,67,False,2057,Penn State
12,School Totals,200,25,60,.417,18,40,.450,7,20,.350,15,20,.750,9,34,43,15,10,10,16,19,72,False,2058,Penn State
12,School Totals,200,22,61,.361,12,33,.364,10,28,.357,12,16,.750,7,19,26,14,5,6,13,17,66,False,2059,Penn State
11,School Totals,200,24,67,.358,18,45,.400,6,22,.273,19,22,.864,11,26,37,14,6,4,12,22,73,False,2060,Penn State
10,School Totals,200,32,64,.500,19,41,.463,13,23,.565,15,23,.652,10,27,37,23,11,3,20,20,92,False,2061,Penn State
14,School Totals,200,34,73,.466,27,49,.551,7,24,.292,21,24,.875,12,36,48,23,11,7,7,19,96,False,2062,Penn State
10,School Totals,200,25,60,.417,21,45,.467,4,15,.267,23,34,.676,8,23,31,10,6,5,11,19,77,False,2063,Penn State
10,School Totals,200,20,55,.364,13,33,.394,7,22,.318,13,18,.722,5,32,37,12,7,3,14,17,60,False,2064,Penn State
10,School Totals,200,24,50,.480,16,31,.516,8,19,.421,13,19,.684,7,29,36,10,2,6,13,17,69,False,1027,Penn State
9,School Totals,200,26,56,.464,21,37,.568,5,19,.263,15,24,.625,8,28,36,18,4,5,13,18,72,False,1413,Penn State
10,School Totals,200,17,56,.304,15,42,.357,2,14,.143,16,20,.800,12,25,37,8,9,5,17,11,52,False,2065,Penn State
10,School Totals,200,23,60,.383,15,40,.375,8,20,.400,21,31,.677,12,18,30,11,10,5,11,19,75,False,254,Penn State
14,School Totals,200,20,64,.313,12,43,.279,8,21,.381,4,6,.667,9,16,25,13,7,3,13,18,52,False,2066,Penn State
11,School Totals,200,19,49,.388,10,31,.323,9,18,.500,8,12,.667,7,16,23,13,5,4,17,22,55,False,2067,Penn State
10,School Totals,200,26,53,.491,17,35,.486,9,18,.500,10,14,.714,5,21,26,13,7,8,12,12,71,False,2068,Penn State
10,School Totals,275,37,80,.463,26,48,.542,11,32,.344,17,29,.586,6,28,34,24,6,4,16,28,102,False,258,Penn State
10,School Totals,200,21,52,.404,12,33,.364,9,19,.474,17,21,.810,8,18,26,14,6,4,13,19,68,False,2069,Penn State
10,School Totals,200,21,49,.429,19,31,.613,2,18,.111,26,38,.684,9,27,36,8,6,6,10,23,70,False,651,Penn State
9,School Totals,200,29,51,.569,22,35,.629,7,16,.438,18,20,.900,5,21,26,10,6,2,14,20,83,False,2070,Penn State
12,School Totals,200,25,63,.397,21,43,.488,4,20,.200,12,16,.750,7,18,25,6,8,5,8,14,66,False,2071,Penn State
10,School Totals,225,29,68,.426,27,50,.540,2,18,.111,10,14,.714,13,25,38,8,12,10,16,18,70,False,2072,Penn State
10,School Totals,200,27,76,.355,20,55,.364,7,21,.333,10,15,.667,9,25,34,16,8,6,5,17,71,False,2073,Penn State
9,School Totals,200,23,55,.418,12,24,.500,11,31,.355,13,19,.684,2,24,26,13,8,5,11,18,70,False,1770,Penn State
11,School Totals,200,31,70,.443,23,42,.548,8,28,.286,9,12,.750,15,21,36,23,6,6,12,19,79,False,2074,Penn State
10,School Totals,225,24,55,.436,17,37,.459,7,18,.389,21,26,.808,9,30,39,11,3,10,13,14,76,False,2075,Penn State
13,School Totals,200,16,55,.291,12,40,.300,4,15,.267,15,19,.789,6,21,27,8,3,3,11,15,51,False,1424,Penn State
11,School Totals,200,24,65,.369,19,46,.413,5,19,.263,33,41,.805,13,26,39,11,8,4,14,24,86,False,2076,Penn State
13,School Totals,200,30,67,.448,26,51,.510,4,16,.250,17,22,.773,15,24,39,17,18,5,23,18,81,False,2077,Penn State
10,School Totals,200,25,50,.500,19,38,.500,6,12,.500,14,24,.583,4,26,30,12,3,9,13,15,70,False,2078,Penn State
9,School Totals,200,27,65,.415,20,42,.476,7,23,.304,18,22,.818,13,28,41,11,10,7,12,14,79,False,2079,Penn State
13,School Totals,200,34,59,.576,25,37,.676,9,22,.409,8,18,.444,10,30,40,16,10,5,11,15,85,False,2080,Penn State
11,School Totals,200,31,61,.508,26,42,.619,5,19,.263,20,28,.714,7,13,20,15,14,5,10,21,87,False,2081,Penn State
15,School Totals,200,32,57,.561,23,37,.622,9,20,.450,13,19,.684,10,25,35,16,14,7,10,13,86,False,2082,Penn State
11,School Totals,200,29,67,.433,24,54,.444,5,13,.385,15,23,.652,17,23,40,12,8,5,16,29,78,False,2083,Penn State
11,School Totals,200,28,64,.438,16,41,.390,12,23,.522,9,11,.818,9,19,28,19,8,7,13,22,77,False,2084,Penn State
10,School Totals,200,20,56,.357,18,42,.429,2,14,.143,21,25,.840,10,21,31,12,6,13,11,16,63,False,2085,Penn State
11,School Totals,200,29,60,.483,22,44,.500,7,16,.438,9,16,.563,13,26,39,14,7,4,15,21,74,False,2086,Penn State
10,School Totals,200,28,57,.491,22,38,.579,6,19,.316,10,16,.625,7,28,35,13,11,4,12,19,72,False,2087,Penn State
11,School Totals,200,31,54,.574,21,37,.568,10,17,.588,8,15,.533,8,26,34,17,7,4,17,10,80,False,2088,Penn State
11,School Totals,200,26,62,.419,17,39,.436,9,23,.391,9,15,.600,10,32,42,16,7,12,13,19,70,False,2089,Penn State
15,School Totals,200,28,57,.491,14,29,.483,14,28,.500,18,23,.783,10,29,39,22,10,4,9,11,88,False,2090,Penn State
10,School Totals,200,29,69,.420,20,43,.465,9,26,.346,2,4,.500,12,22,34,20,4,3,6,24,69,False,676,Penn State
9,School Totals,200,30,55,.545,27,42,.643,3,13,.231,15,23,.652,10,28,38,15,9,8,15,11,78,False,2091,Penn State
9,School Totals,200,26,52,.500,20,38,.526,6,14,.429,12,18,.667,5,25,30,8,5,4,14,20,70,False,286,Penn State
10,School Totals,225,26,66,.394,19,46,.413,7,20,.350,17,24,.708,12,31,43,15,3,4,12,18,76,False,2092,Penn State
10,School Totals,225,33,74,.446,26,52,.500,7,22,.318,11,15,.733,8,25,33,12,8,5,4,18,84,False,2093,Penn State
9,School Totals,200,22,43,.512,15,24,.625,7,19,.368,10,12,.833,6,18,24,11,1,6,14,18,61,False,2094,Penn State
10,School Totals,200,28,48,.583,17,34,.500,11,14,.786,15,20,.750,6,15,21,10,2,1,10,13,82,False,1791,Penn State
11,School Totals,200,24,55,.436,19,37,.514,5,18,.278,7,12,.583,8,31,39,12,7,5,14,13,60,False,2095,Penn State
11,School Totals,200,26,69,.377,19,45,.422,7,24,.292,9,11,.818,8,20,28,13,10,3,8,21,68,False,1447,Penn State
11,School Totals,200,35,64,.547,30,49,.612,5,15,.333,7,10,.700,9,25,34,13,5,6,9,19,82,False,2096,Penn State
10,School Totals,200,27,52,.519,18,31,.581,9,21,.429,11,18,.611,9,15,24,14,6,3,9,12,74,False,685,Penn State
11,School Totals,200,30,55,.545,23,31,.742,7,24,.292,7,11,.636,8,17,25,20,6,3,11,16,74,False,2097,Penn State
12,School Totals,200,26,54,.481,17,34,.500,9,20,.450,18,27,.667,9,22,31,14,8,7,10,19,79,False,1795,Penn State
11,School Totals,200,28,56,.500,19,38,.500,9,18,.500,8,13,.615,11,22,33,14,5,5,15,22,73,False,2098,Penn State
12,School Totals,200,25,59,.424,18,41,.439,7,18,.389,6,11,.545,4,22,26,10,6,6,10,19,63,False,1075,Penn State
10,School Totals,200,24,59,.407,20,42,.476,4,17,.235,12,19,.632,8,17,25,6,11,3,13,19,64,False,2099,Penn State
10,School Totals,200,22,61,.361,9,32,.281,13,29,.448,8,12,.667,11,20,31,12,3,4,4,14,65,False,2100,Penn State
9,School Totals,200,22,58,.379,13,39,.333,9,19,.474,16,20,.800,12,25,37,14,5,3,8,15,69,False,1797,Penn State
10,School Totals,200,20,59,.339,12,37,.324,8,22,.364,22,27,.815,10,20,30,9,7,2,7,21,70,False,2101,Penn State
12,School Totals,200,18,49,.367,11,29,.379,7,20,.350,20,30,.667,10,26,36,11,5,4,11,20,63,False,2102,Penn State
9,School Totals,200,22,58,.379,13,32,.406,9,26,.346,20,25,.800,8,24,32,11,8,5,9,17,73,False,2103,Penn State
9,School Totals,200,31,58,.534,25,44,.568,6,14,.429,17,21,.810,10,17,27,14,4,1,12,17,85,False,2104,Penn State
11,School Totals,200,29,59,.492,18,39,.462,11,20,.550,6,10,.600,6,20,26,18,9,3,5,19,75,False,2105,Penn State
10,School Totals,200,32,58,.552,23,36,.639,9,22,.409,9,11,.818,7,26,33,22,4,4,10,13,82,False,2106,Penn State
10,School Totals,200,27,57,.474,19,36,.528,8,21,.381,25,35,.714,4,29,33,17,7,5,15,19,87,False,2107,Penn State
9,School Totals,200,26,64,.406,16,32,.500,10,32,.313,14,21,.667,12,19,31,10,7,3,6,17,76,False,2108,Penn State
10,School Totals,225,25,64,.391,15,34,.441,10,30,.333,10,16,.625,9,25,34,13,10,2,16,23,70,False,2109,Penn State
11,School Totals,200,29,50,.580,20,33,.606,9,17,.529,10,14,.714,4,24,28,13,8,0,15,22,77,False,2110,Penn State
9,School Totals,200,17,59,.288,13,32,.406,4,27,.148,18,22,.818,19,24,43,6,7,3,12,19,56,False,2111,Penn State
10,School Totals,200,25,57,.439,16,28,.571,9,29,.310,4,7,.571,13,22,35,14,8,5,16,16,63,False,2112,Penn State
10,School Totals,200,25,63,.397,20,42,.476,5,21,.238,4,6,.667,8,17,25,9,12,2,8,24,59,False,699,Penn State
10,School Totals,200,23,62,.371,18,41,.439,5,21,.238,11,26,.423,14,26,40,11,12,2,9,16,62,False,309,Penn State
10,School Totals,200,25,60,.417,15,34,.441,10,26,.385,16,19,.842,12,27,39,15,7,5,16,13,76,False,2113,Penn State
9,School Totals,200,27,64,.422,21,47,.447,6,17,.353,18,27,.667,8,19,27,13,9,2,14,20,78,False,2114,Penn State
10,School Totals,200,24,59,.407,16,42,.381,8,17,.471,17,26,.654,18,23,41,13,8,4,17,21,73,False,2115,Penn State
10,School Totals,200,26,68,.382,19,43,.442,7,25,.280,5,5,1.000,9,24,33,16,8,6,10,20,64,False,2116,Penn State
15,School Totals,200,25,50,.500,15,29,.517,10,21,.476,14,21,.667,9,22,31,14,6,6,9,14,74,False,2117,Penn State
10,School Totals,200,24,57,.421,23,43,.535,1,14,.071,6,9,.667,7,30,37,6,6,3,17,16,55,False,1099,Penn State
10,School Totals,200,20,53,.377,16,33,.485,4,20,.200,8,13,.615,9,24,33,10,4,2,16,13,52,False,2118,Penn State
10,School Totals,200,25,69,.362,18,45,.400,7,24,.292,7,12,.583,17,24,41,11,3,4,8,15,64,False,2119,Penn State
11,School Totals,200,22,60,.367,17,38,.447,5,22,.227,7,10,.700,7,18,25,11,8,4,13,19,56,False,1473,Penn State
10,School Totals,200,30,64,.469,18,29,.621,12,35,.343,10,13,.769,5,27,32,23,6,5,12,20,82,False,2120,Penn State
11,School Totals,200,22,52,.423,14,35,.400,8,17,.471,12,20,.600,7,22,29,13,8,4,12,22,64,False,2121,Penn State
11,School Totals,200,20,57,.351,14,33,.424,6,24,.250,14,20,.700,10,22,32,9,8,7,14,19,60,False,2122,Penn State
10,School Totals,225,24,61,.393,12,32,.375,12,29,.414,30,41,.732,14,21,35,13,2,3,9,20,90,False,2123,Penn State
11,School Totals,200,20,53,.377,17,38,.447,3,15,.200,16,26,.615,8,27,35,12,9,5,9,15,59,False,2124,Penn State
11,School Totals,200,26,60,.433,22,46,.478,4,14,.286,14,18,.778,6,19,25,8,12,1,10,23,70,False,1818,Penn State
10,School Totals,200,24,52,.462,18,37,.486,6,15,.400,21,34,.618,11,20,31,7,7,3,11,13,75,False,1108,Penn State
12,School Totals,200,23,60,.383,18,36,.500,5,24,.208,13,17,.765,8,12,20,11,13,3,16,24,64,False,2125,Penn State
13,School Totals,200,35,63,.556,24,41,.585,11,22,.500,14,16,.875,13,21,34,17,8,3,6,17,95,False,2126,Penn State
10,School Totals,200,26,53,.491,21,36,.583,5,17,.294,26,32,.813,8,29,37,12,4,7,17,26,83,False,2127,Penn State
10,School Totals,200,27,59,.458,20,39,.513,7,20,.350,17,21,.810,10,19,29,16,11,2,10,15,78,False,719,Penn State
9,School Totals,200,19,54,.352,14,38,.368,5,16,.313,14,19,.737,9,25,34,6,2,7,11,17,57,False,2128,Penn State
9,School Totals,200,26,66,.394,19,49,.388,7,17,.412,7,13,.538,13,30,43,9,9,8,12,18,66,False,2129,Penn State
10,School Totals,200,24,57,.421,15,28,.536,9,29,.310,15,22,.682,9,24,33,18,10,3,15,18,72,False,2130,Penn State
10,School Totals,225,30,71,.423,26,56,.464,4,15,.267,8,12,.667,12,22,34,13,6,3,10,23,72,False,2131,Penn State
14,School Totals,200,29,58,.500,17,27,.630,12,31,.387,14,24,.583,13,25,38,19,10,11,15,17,84,False,2132,Penn State
12,School Totals,200,30,65,.462,19,35,.543,11,30,.367,20,33,.606,10,28,38,16,9,2,12,19,91,False,2133,Penn State
10,School Totals,200,28,63,.444,15,34,.441,13,29,.448,12,17,.706,9,30,39,19,15,5,20,21,81,False,2134,Penn State
12,School Totals,200,39,65,.600,34,49,.694,5,16,.313,15,23,.652,11,25,36,15,8,6,9,9,98,False,2135,Penn State
11,School Totals,200,23,69,.333,18,42,.429,5,27,.185,7,9,.778,14,29,43,14,12,4,6,15,58,False,2136,Penn State
10,School Totals,200,26,58,.448,21,39,.538,5,19,.263,15,18,.833,6,25,31,16,10,12,16,20,72,False,2137,Penn State
11,School Totals,200,27,67,.403,17,37,.459,10,30,.333,21,31,.677,20,31,51,18,6,4,13,21,85,False,2138,Penn State
14,School Totals,200,30,68,.441,25,40,.625,5,28,.179,11,17,.647,15,32,47,12,12,6,14,21,76,False,2139,Penn State
12,School Totals,200,25,59,.424,15,30,.500,10,29,.345,14,20,.700,8,11,19,7,5,3,10,25,74,False,1835,Penn State
10,School Totals,200,29,68,.426,22,49,.449,7,19,.368,11,14,.786,8,23,31,19,10,10,8,16,76,False,735,Penn State
11,School Totals,200,23,63,.365,15,36,.417,8,27,.296,19,26,.731,8,36,44,14,6,7,16,14,73,False,2140,Penn State
14,School Totals,200,33,61,.541,23,31,.742,10,30,.333,11,13,.846,6,28,34,24,9,10,13,17,87,False,2141,Penn State
14,School Totals,200,35,67,.522,27,41,.659,8,26,.308,12,18,.667,14,24,38,16,8,3,11,17,90,False,2142,Penn State
11,School Totals,200,33,72,.458,25,44,.568,8,28,.286,15,22,.682,15,19,34,13,11,5,7,16,89,False,2143,Penn State
11,School Totals,200,22,61,.361,16,35,.457,6,26,.231,11,13,.846,7,24,31,9,4,4,14,23,61,False,2144,Penn State
10,School Totals,200,17,52,.327,12,31,.387,5,21,.238,10,14,.714,5,27,32,8,6,5,10,14,49,False,2145,Penn State
11,School Totals,200,25,59,.424,19,39,.487,6,20,.300,13,20,.650,9,19,28,12,5,5,6,22,69,False,2146,Penn State
11,School Totals,200,29,54,.537,20,35,.571,9,19,.474,23,28,.821,6,23,29,14,9,7,9,24,90,False,1842,Penn State
10,School Totals,200,27,56,.482,19,37,.514,8,19,.421,10,16,.625,2,29,31,9,4,1,12,15,72,False,1136,Penn State
10,School Totals,200,24,64,.375,19,46,.413,5,18,.278,11,23,.478,9,25,34,12,15,3,7,12,64,False,356,Penn State
13,School Totals,200,30,67,.448,20,41,.488,10,26,.385,6,14,.429,13,34,47,16,5,4,15,17,76,False,2147,Penn State
10,School Totals,200,26,63,.413,17,42,.405,9,21,.429,14,19,.737,9,21,30,16,9,2,8,15,75,False,1510,Penn State
9,School Totals,200,29,58,.500,23,41,.561,6,17,.353,19,26,.731,8,28,36,16,3,4,10,15,83,False,2148,Penn State
9,School Totals,200,28,54,.519,14,28,.500,14,26,.538,18,22,.818,5,23,28,21,4,2,8,18,88,False,2149,Penn State
12,School Totals,200,28,65,.431,17,34,.500,11,31,.355,10,14,.714,12,28,40,16,7,4,10,17,77,False,2150,Penn State
9,School Totals,200,21,58,.362,17,39,.436,4,19,.211,10,13,.769,9,23,32,13,5,4,7,16,56,False,2151,Penn State
10,School Totals,200,22,53,.415,20,39,.513,2,14,.143,14,22,.636,9,25,34,4,6,3,15,24,60,False,362,Penn State
9,School Totals,200,22,56,.393,15,34,.441,7,22,.318,14,22,.636,7,30,37,13,5,3,13,13,65,False,2152,Penn State
11,School Totals,200,26,70,.371,16,39,.410,10,31,.323,6,10,.600,13,26,39,13,6,5,10,15,68,False,2153,Penn State
10,School Totals,200,23,68,.338,13,38,.342,10,30,.333,15,20,.750,14,18,32,17,5,4,2,18,71,False,1514,Penn State
10,School Totals,200,23,70,.329,13,34,.382,10,36,.278,13,17,.765,13,27,40,12,4,2,8,17,69,False,2154,Penn State
13,School Totals,200,31,72,.431,20,36,.556,11,36,.306,13,14,.929,15,23,38,13,18,4,11,18,86,False,2155,Penn State
10,School Totals,200,25,61,.410,16,35,.457,9,26,.346,13,19,.684,9,25,34,14,9,3,15,19,72,False,2156,Penn State
10,School Totals,225,32,70,.457,19,36,.528,13,34,.382,15,19,.789,7,25,32,20,5,2,14,29,92,False,2157,Penn State
16,School Totals,200,30,60,.500,18,37,.486,12,23,.522,3,8,.375,8,25,33,15,6,6,4,17,75,False,2158,Penn State
10,School Totals,200,20,65,.308,13,46,.283,7,19,.368,11,15,.733,10,20,30,10,7,2,8,17,58,False,1153,Penn State
11,School Totals,200,35,65,.538,28,42,.667,7,23,.304,4,7,.571,8,17,25,15,6,5,12,23,81,False,2159,Penn State
10,School Totals,225,31,65,.477,19,37,.514,12,28,.429,11,15,.733,8,20,28,13,7,2,14,20,85,False,377,Penn State
10,School Totals,200,27,82,.329,17,43,.395,10,39,.256,8,13,.615,18,25,43,11,7,3,6,26,72,False,2160,Penn State
13,School Totals,200,21,62,.339,14,44,.318,7,18,.389,16,21,.762,12,24,36,8,10,0,15,26,65,False,2161,Penn State
8,School Totals,200,27,55,.491,21,36,.583,6,19,.316,15,24,.625,12,26,38,16,10,2,14,11,75,False,2162,Penn State
10,School Totals,200,26,55,.473,17,35,.486,9,20,.450,20,26,.769,12,25,37,12,10,4,16,15,81,False,2163,Penn State
10,School Totals,200,26,59,.441,17,40,.425,9,19,.474,18,24,.750,9,15,24,9,6,0,11,19,79,False,1867,Penn State
9,School Totals,200,27,60,.450,19,36,.528,8,24,.333,19,25,.760,5,28,33,14,6,1,6,10,81,False,2164,Penn State
15,School Totals,200,22,57,.386,16,33,.485,6,24,.250,6,10,.600,10,14,24,10,6,3,13,16,56,False,2165,Penn State
9,School Totals,200,17,54,.315,12,31,.387,5,23,.217,16,18,.889,9,28,37,10,7,2,13,16,55,False,771,Penn State
9,School Totals,200,20,58,.345,15,35,.429,5,23,.217,13,15,.867,7,23,30,12,5,1,9,16,58,False,1532,Penn State
9,School Totals,200,21,65,.323,12,34,.353,9,31,.290,10,12,.833,11,22,33,13,7,3,11,9,61,False,2166,Penn State
9,School Totals,200,27,60,.450,15,32,.469,12,28,.429,16,21,.762,8,17,25,16,7,2,10,20,82,False,1869,Penn State
10,School Totals,200,22,62,.355,11,29,.379,11,33,.333,13,17,.765,7,27,34,13,10,2,10,20,68,False,2167,Penn State
11,School Totals,200,28,70,.400,14,33,.424,14,37,.378,16,19,.842,13,25,38,19,14,1,14,17,86,False,2168,Penn State
16,School Totals,200,22,62,.355,16,33,.485,6,29,.207,2,8,.250,6,18,24,11,6,4,12,15,52,False,2169,Penn State
16,School Totals,200,32,70,.457,22,45,.489,10,25,.400,10,19,.526,16,28,44,19,5,2,6,15,84,False,2170,Penn State
10,School Totals,200,19,56,.339,10,30,.333,9,26,.346,19,24,.792,10,28,38,10,9,0,9,16,66,False,779,Penn State
9,School Totals,200,21,59,.356,14,32,.438,7,27,.259,23,29,.793,13,29,42,15,10,2,14,18,72,False,2171,Penn State
10,School Totals,200,28,58,.483,21,38,.553,7,20,.350,11,13,.846,8,23,31,17,5,3,8,18,74,False,2172,Penn State
11,School Totals,200,27,61,.443,20,36,.556,7,25,.280,13,21,.619,11,25,36,19,8,9,11,17,74,False,2173,Rutgers
11,School Totals,200,20,44,.455,18,37,.486,2,7,.286,16,35,.457,8,26,34,7,5,11,15,18,58,False,2174,Rutgers
11,School Totals,200,26,52,.500,20,36,.556,6,16,.375,13,19,.684,8,22,30,11,2,7,20,18,71,False,2175,Rutgers
10,School Totals,200,29,52,.558,21,38,.553,8,14,.571,17,24,.708,7,21,28,19,7,6,14,21,83,False,2176,Rutgers
13,School Totals,200,23,56,.411,20,40,.500,3,16,.188,9,15,.600,13,15,28,12,7,6,15,11,58,False,2177,Rutgers
13,School Totals,200,17,46,.370,13,35,.371,4,11,.364,20,23,.870,10,26,36,12,5,9,15,13,58,False,2178,Rutgers
12,School Totals,200,20,51,.392,13,31,.419,7,20,.350,29,38,.763,8,29,37,12,6,9,12,13,76,False,2179,Rutgers
10,School Totals,200,20,57,.351,14,39,.359,6,18,.333,20,33,.606,18,21,39,13,9,8,13,12,66,False,2180,Rutgers
10,School Totals,225,27,63,.429,15,42,.357,12,21,.571,14,24,.583,10,29,39,20,1,10,12,18,80,False,2181,Rutgers
11,School Totals,200,23,49,.469,20,35,.571,3,14,.214,22,26,.846,12,26,38,14,8,12,22,16,71,False,2182,Rutgers
13,School Totals,200,26,54,.481,21,38,.553,5,16,.313,9,13,.692,8,36,44,14,3,18,16,12,66,False,2183,Rutgers
10,School Totals,200,30,70,.429,27,47,.574,3,23,.130,4,9,.444,11,19,30,14,6,4,13,24,67,False,2184,Rutgers
10,School Totals,200,20,54,.370,13,35,.371,7,19,.368,11,12,.917,7,18,25,10,7,4,11,20,58,False,2185,Rutgers
10,School Totals,200,20,47,.426,17,37,.459,3,10,.300,9,15,.600,7,16,23,9,3,5,19,14,52,False,2186,Rutgers
10,School Totals,200,31,73,.425,23,43,.535,8,30,.267,11,14,.786,16,19,35,17,4,5,15,25,81,False,2187,Rutgers
10,School Totals,200,25,65,.385,14,34,.412,11,31,.355,4,5,.800,13,18,31,14,13,3,21,14,65,False,2188,Rutgers
10,School Totals,200,23,62,.371,17,42,.405,6,20,.300,12,20,.600,9,25,34,12,8,4,19,21,64,False,2189,Rutgers
12,School Totals,200,25,61,.410,18,35,.514,7,26,.269,11,21,.524,10,17,27,16,6,8,13,23,68,False,2190,Rutgers
10,School Totals,200,24,57,.421,14,28,.500,10,29,.345,5,9,.556,9,15,24,14,5,4,14,15,63,False,2191,Rutgers
10,School Totals,200,23,55,.418,16,36,.444,7,19,.368,6,8,.750,10,23,33,12,5,4,19,14,59,False,2192,Rutgers
9,School Totals,200,24,60,.400,16,38,.421,8,22,.364,18,26,.692,13,30,43,10,5,8,12,11,74,False,2193,Rutgers
9,School Totals,200,31,55,.564,23,40,.575,8,15,.533,14,19,.737,11,25,36,18,7,11,16,16,84,False,2194,Rutgers
9,School Totals,200,23,60,.383,17,41,.415,6,19,.316,8,12,.667,11,15,26,17,9,1,10,15,60,False,2195,Rutgers
9,School Totals,200,22,52,.423,11,24,.458,11,28,.393,15,19,.789,7,27,34,17,10,7,16,10,70,False,2196,Rutgers
10,School Totals,200,26,58,.448,19,40,.475,7,18,.389,12,16,.750,11,17,28,17,8,6,8,12,71,False,2197,Rutgers
9,School Totals,200,24,53,.453,16,31,.516,8,22,.364,12,19,.632,17,25,42,13,3,6,18,13,68,False,2198,Rutgers
9,School Totals,200,21,60,.350,15,39,.385,6,21,.286,10,20,.500,13,19,32,11,7,7,15,17,58,False,2199,Rutgers
9,School Totals,200,26,68,.382,21,46,.457,5,22,.227,13,20,.650,17,28,45,9,3,7,16,13,70,False,2200,Rutgers
10,School Totals,200,25,48,.521,18,28,.643,7,20,.350,14,19,.737,11,21,32,18,6,8,17,14,71,False,2201,Rutgers
9,School Totals,200,26,72,.361,19,49,.388,7,23,.304,15,24,.625,13,25,38,13,8,7,4,19,74,False,2202,Rutgers
12,School Totals,200,18,44,.409,14,28,.500,4,16,.250,14,22,.636,5,14,19,8,1,6,12,20,54,False,2203,Rutgers
9,School Totals,200,22,51,.431,13,27,.481,9,24,.375,15,23,.652,4,24,28,16,1,7,7,18,68,False,2204,Rutgers
11,School Totals,225,29,59,.492,24,44,.545,5,15,.333,10,18,.556,8,17,25,10,13,3,11,24,73,False,2205,Rutgers
10,School Totals,200,27,56,.482,19,38,.500,8,18,.444,6,13,.462,9,24,33,14,7,10,10,19,68,False,2206,Rutgers
14,School Totals,200,24,56,.429,19,40,.475,5,16,.313,8,10,.800,10,22,32,17,11,6,12,20,61,False,2207,Rutgers
14,School Totals,200,33,66,.500,24,50,.480,9,16,.563,8,15,.533,13,22,35,17,7,3,10,23,83,False,2208,Rutgers
10,School Totals,200,27,59,.458,21,41,.512,6,18,.333,10,19,.526,9,17,26,16,9,4,9,21,70,False,2209,Rutgers
11,School Totals,200,22,48,.458,20,38,.526,2,10,.200,20,25,.800,9,24,33,6,9,8,13,15,66,False,2210,Rutgers
10,School Totals,200,25,60,.417,22,41,.537,3,19,.158,11,16,.688,14,23,37,13,10,7,14,19,64,False,2211,Rutgers
10,School Totals,200,20,59,.339,13,37,.351,7,22,.318,16,19,.842,16,24,40,13,3,5,10,18,63,False,2212,Rutgers
12,School Totals,200,28,54,.519,21,36,.583,7,18,.389,16,23,.696,10,20,30,22,12,5,13,19,79,False,2213,Rutgers
14,School Totals,200,31,63,.492,22,44,.500,9,19,.474,8,12,.667,15,26,41,17,7,3,13,15,79,False,2214,Rutgers
10,School Totals,200,19,46,.413,16,35,.457,3,11,.273,14,27,.519,8,22,30,11,9,5,11,14,55,False,2215,Rutgers
12,School Totals,200,20,59,.339,15,37,.405,5,22,.227,10,16,.625,6,24,30,10,11,4,16,21,55,False,2216,Rutgers
11,School Totals,200,20,48,.417,17,35,.486,3,13,.231,22,28,.786,5,12,17,13,9,7,14,28,65,False,2217,Rutgers
9,School Totals,200,26,56,.464,17,38,.447,9,18,.500,4,11,.364,13,15,28,17,9,4,13,24,65,False,2218,Rutgers
9,School Totals,200,31,57,.544,28,49,.571,3,8,.375,20,27,.741,9,27,36,18,7,10,15,25,85,False,2219,Rutgers
12,School Totals,200,20,58,.345,17,41,.415,3,17,.176,10,14,.714,10,23,33,8,6,5,9,16,53,False,2220,Rutgers
9,School Totals,200,25,58,.431,19,42,.452,6,16,.375,9,13,.692,14,14,28,14,7,6,12,18,65,False,2221,Rutgers
10,School Totals,200,23,50,.460,15,35,.429,8,15,.533,17,21,.810,4,19,23,12,10,5,7,17,71,False,2222,Rutgers
9,School Totals,200,25,53,.472,22,43,.512,3,10,.300,13,27,.481,10,28,38,6,4,6,13,12,66,False,2223,Rutgers
9,School Totals,200,23,50,.460,22,39,.564,1,11,.091,9,14,.643,5,17,22,9,6,1,13,22,56,False,2224,Rutgers
10,School Totals,200,22,57,.386,17,39,.436,5,18,.278,13,18,.722,4,18,22,11,5,8,6,26,62,False,2225,Rutgers
10,School Totals,200,20,42,.476,13,26,.500,7,16,.438,9,14,.643,9,21,30,16,5,8,23,23,56,False,2226,Rutgers
10,School Totals,200,27,62,.435,20,42,.476,7,20,.350,8,12,.667,7,22,29,16,9,2,7,26,69,False,2227,Rutgers
10,School Totals,200,27,57,.474,19,40,.475,8,17,.471,15,21,.714,13,13,26,15,7,0,8,19,77,False,2228,Rutgers
10,School Totals,200,23,53,.434,15,34,.441,8,19,.421,10,10,1.000,5,16,21,18,7,1,18,13,64,False,2229,Rutgers
10,School Totals,225,31,68,.456,22,45,.489,9,23,.391,9,14,.643,13,18,31,17,10,1,11,29,80,False,2230,Rutgers
13,School Totals,200,13,44,.295,11,30,.367,2,14,.143,9,14,.643,6,24,30,12,6,3,18,14,37,False,2231,Rutgers
12,School Totals,200,20,59,.339,19,46,.413,1,13,.077,13,16,.813,9,17,26,8,7,4,6,22,54,False,2232,Rutgers
9,School Totals,200,26,58,.448,21,48,.438,5,10,.500,11,15,.733,11,22,33,16,7,2,9,16,68,False,2233,Rutgers
9,School Totals,200,31,52,.596,25,40,.625,6,12,.500,6,9,.667,6,20,26,15,5,1,14,17,74,False,2234,Rutgers
10,School Totals,225,23,50,.460,17,34,.500,6,16,.375,24,37,.649,8,27,35,13,13,1,14,16,76,False,2235,Rutgers
10,School Totals,200,22,61,.361,16,42,.381,6,19,.316,13,15,.867,14,17,31,14,5,5,14,20,63,False,2236,Rutgers
12,School Totals,200,22,46,.478,20,42,.476,2,4,.500,16,23,.696,8,23,31,9,7,6,16,17,62,False,2237,Rutgers
11,School Totals,200,24,65,.369,15,42,.357,9,23,.391,0,6,.000,17,15,32,12,3,2,14,17,57,False,2238,Rutgers
14,School Totals,200,34,54,.630,29,44,.659,5,10,.500,18,25,.720,10,16,26,15,12,2,16,23,91,False,2239,Rutgers
11,School Totals,200,20,63,.317,17,47,.362,3,16,.188,23,27,.852,16,23,39,13,13,3,16,22,66,False,2240,Rutgers
12,School Totals,200,29,61,.475,25,49,.510,4,12,.333,8,18,.444,9,16,25,13,8,1,11,26,70,False,2241,Rutgers
11,School Totals,200,19,53,.358,17,44,.386,2,9,.222,13,18,.722,12,16,28,5,6,3,18,19,53,False,2242,Rutgers
14,School Totals,200,34,61,.557,24,44,.545,10,17,.588,16,20,.800,12,24,36,27,13,4,15,20,94,False,2243,Rutgers
11,School Totals,200,15,45,.333,13,34,.382,2,11,.182,18,24,.750,8,22,30,9,16,2,17,21,50,False,2244,Rutgers
11,School Totals,200,20,53,.377,16,37,.432,4,16,.250,13,18,.722,13,22,35,8,8,5,18,19,57,False,2245,Rutgers
13,School Totals,200,27,57,.474,20,39,.513,7,18,.389,20,27,.741,14,20,34,19,10,11,17,21,81,False,2246,Rutgers
9,School Totals,200,24,46,.522,22,39,.564,2,7,.286,17,22,.773,6,20,26,9,8,9,15,21,67,False,2247,Rutgers
12,School Totals,200,27,62,.435,25,48,.521,2,14,.143,21,28,.750,15,30,45,15,9,7,15,17,77,False,2248,Rutgers
10,School Totals,250,35,72,.486,28,54,.519,7,18,.389,8,11,.727,8,24,32,18,6,2,11,18,85,False,2249,Rutgers
11,School Totals,200,25,54,.463,19,39,.487,6,15,.400,9,11,.818,10,12,22,11,13,5,14,18,65,False,2250,Rutgers
14,School Totals,200,24,52,.462,20,36,.556,4,16,.250,12,25,.480,7,15,22,13,9,2,15,31,64,False,2251,Rutgers
10,School Totals,200,19,48,.396,12,30,.400,7,18,.389,22,27,.815,8,17,25,11,9,1,14,20,67,False,2252,Rutgers
14,School Totals,200,22,55,.400,17,36,.472,5,19,.263,13,20,.650,15,29,44,10,4,6,13,16,62,False,2253,Rutgers
14,School Totals,200,23,58,.397,20,44,.455,3,14,.214,11,20,.550,7,26,33,12,6,5,19,30,60,False,2254,Rutgers
10,School Totals,200,24,55,.436,17,40,.425,7,15,.467,10,14,.714,9,21,30,14,5,4,10,19,65,False,2255,Rutgers
11,School Totals,200,20,53,.377,14,37,.378,6,16,.375,4,7,.571,7,18,25,12,8,2,15,29,50,False,2256,Rutgers
10,School Totals,200,25,58,.431,19,42,.452,6,16,.375,8,15,.533,11,18,29,17,9,8,14,15,64,False,2257,Rutgers
9,School Totals,200,22,48,.458,17,34,.500,5,14,.357,12,19,.632,10,22,32,17,7,2,12,12,61,False,2258,Rutgers
10,School Totals,200,26,61,.426,21,44,.477,5,17,.294,10,17,.588,14,18,32,10,7,2,13,21,67,False,2259,Rutgers
11,School Totals,200,24,59,.407,14,34,.412,10,25,.400,8,9,.889,5,17,22,12,10,1,13,21,66,False,2260,Rutgers
11,School Totals,200,17,54,.315,11,31,.355,6,23,.261,14,20,.700,11,16,27,8,10,8,16,20,54,False,2261,Rutgers
13,School Totals,200,22,56,.393,19,42,.452,3,14,.214,6,10,.600,11,22,33,10,5,5,13,26,53,False,2262,Rutgers
9,School Totals,200,26,62,.419,23,44,.523,3,18,.167,9,11,.818,10,21,31,15,6,2,12,21,64,False,2263,Rutgers
14,School Totals,200,28,66,.424,22,49,.449,6,17,.353,3,3,1.000,14,15,29,15,8,2,21,18,65,False,2264,Rutgers
11,School Totals,225,29,55,.527,19,40,.475,10,15,.667,9,12,.750,9,20,29,17,5,5,15,20,77,False,2265,Rutgers
11,School Totals,200,22,62,.355,17,41,.415,5,21,.238,22,26,.846,12,15,27,12,9,3,10,26,71,False,2266,Rutgers
13,School Totals,200,20,53,.377,15,35,.429,5,18,.278,16,21,.762,14,26,40,10,6,1,14,21,61,False,2267,Rutgers
13,School Totals,200,16,55,.291,8,37,.216,8,18,.444,9,17,.529,10,13,23,9,6,1,14,22,49,False,2268,Rutgers
12,School Totals,200,19,53,.358,17,40,.425,2,13,.154,12,18,.667,15,25,40,10,3,1,17,15,52,False,2269,Rutgers
14,School Totals,200,37,68,.544,34,54,.630,3,14,.214,11,20,.550,14,23,37,20,8,10,7,14,88,False,2270,Rutgers
10,School Totals,200,17,43,.395,10,30,.333,7,13,.538,17,24,.708,10,30,40,7,6,5,15,17,58,False,2271,Rutgers
12,School Totals,200,28,58,.483,24,44,.545,4,14,.286,21,28,.750,13,23,36,17,4,4,9,20,81,False,2272,Rutgers
11,School Totals,200,31,54,.574,27,44,.614,4,10,.400,21,25,.840,5,22,27,12,12,5,18,21,87,False,2273,Rutgers
12,School Totals,200,22,54,.407,17,38,.447,5,16,.313,18,26,.692,6,31,37,14,6,2,14,31,67,False,2274,Rutgers
11,School Totals,200,30,62,.484,24,46,.522,6,16,.375,15,21,.714,15,29,44,17,8,5,24,18,81,False,2275,Rutgers
11,School Totals,200,25,58,.431,22,44,.500,3,14,.214,15,23,.652,10,14,24,11,15,10,14,15,68,False,2276,Rutgers
11,School Totals,200,27,45,.600,22,35,.629,5,10,.500,29,33,.879,4,23,27,18,13,4,22,17,88,False,2277,Rutgers
13,School Totals,200,33,55,.600,25,43,.581,8,12,.667,5,7,.714,7,15,22,17,13,3,9,17,79,False,2278,Rutgers
12,School Totals,200,24,56,.429,23,48,.479,1,8,.125,19,25,.760,7,21,28,12,6,2,8,20,68,False,2279,Rutgers
12,School Totals,200,20,55,.364,14,37,.378,6,18,.333,7,8,.875,7,23,30,14,4,3,20,17,53,False,2280,Rutgers
11,School Totals,200,22,43,.512,16,29,.552,6,14,.429,17,20,.850,7,24,31,13,7,5,17,18,67,False,2281,Rutgers
10,School Totals,200,22,55,.400,17,40,.425,5,15,.333,9,14,.643,7,21,28,10,7,2,12,20,58,False,2282,Rutgers
10,School Totals,200,20,53,.377,15,36,.417,5,17,.294,13,17,.765,11,21,32,11,2,3,9,25,58,False,2283,Rutgers
10,School Totals,200,28,59,.475,22,41,.537,6,18,.333,8,10,.800,9,19,28,13,3,2,6,13,70,False,2284,Rutgers
10,School Totals,200,28,61,.459,24,49,.490,4,12,.333,6,7,.857,11,16,27,15,11,4,15,18,66,False,2285,Rutgers
10,School Totals,200,23,63,.365,18,47,.383,5,16,.313,9,17,.529,12,26,38,10,6,1,17,27,60,False,2286,Rutgers
10,School Totals,200,22,56,.393,17,38,.447,5,18,.278,5,10,.500,8,22,30,11,7,3,16,19,54,False,2287,Rutgers
11,School Totals,200,18,48,.375,10,31,.323,8,17,.471,10,11,.909,4,17,21,8,8,2,20,25,54,False,2288,Rutgers
12,School Totals,200,16,50,.320,12,38,.316,4,12,.333,12,22,.545,15,13,28,7,5,5,16,18,48,False,2289,Rutgers
11,School Totals,200,21,54,.389,13,36,.361,8,18,.444,13,18,.722,14,11,25,12,6,0,8,16,63,False,2290,Rutgers
12,School Totals,200,18,46,.391,13,33,.394,5,13,.385,16,25,.640,9,23,32,13,6,11,12,21,57,False,2291,Rutgers
12,School Totals,200,25,54,.463,20,42,.476,5,12,.417,14,20,.700,12,17,29,12,8,1,12,21,69,False,2292,Rutgers
10,School Totals,200,24,56,.429,21,48,.438,3,8,.375,12,15,.800,15,17,32,13,4,2,12,23,63,False,2293,Rutgers
10,School Totals,200,26,64,.406,23,55,.418,3,9,.333,17,24,.708,16,26,42,9,2,4,7,21,72,False,2294,Rutgers
10,School Totals,200,20,54,.370,15,40,.375,5,14,.357,6,15,.400,6,17,23,12,7,1,12,30,51,False,2295,Rutgers
10,School Totals,200,23,50,.460,19,41,.463,4,9,.444,4,9,.444,11,15,26,14,4,4,15,16,54,False,2296,Rutgers
10,School Totals,200,19,46,.413,14,32,.438,5,14,.357,13,18,.722,7,17,24,10,13,1,14,14,56,False,2297,Rutgers
12,School Totals,200,33,54,.611,27,43,.628,6,11,.545,4,7,.571,7,27,34,15,7,5,14,18,76,False,2298,Rutgers
10,School Totals,200,26,62,.419,22,47,.468,4,15,.267,5,11,.455,9,18,27,13,5,3,6,18,61,False,2299,Rutgers
12,School Totals,200,31,64,.484,25,45,.556,6,19,.316,24,35,.686,16,30,46,13,9,6,15,23,92,False,2300,Rutgers
10,School Totals,200,25,58,.431,18,37,.486,7,21,.333,19,26,.731,4,19,23,14,5,6,3,25,76,False,2301,Rutgers
10,School Totals,200,24,55,.436,19,39,.487,5,16,.313,19,28,.679,11,20,31,9,10,3,12,20,72,False,2302,Rutgers
10,School Totals,200,23,63,.365,17,37,.459,6,26,.231,14,22,.636,15,30,45,15,4,4,7,15,66,False,2303,Rutgers
12,School Totals,200,21,53,.396,17,38,.447,4,15,.267,13,21,.619,9,23,32,9,3,3,14,23,59,False,2304,Rutgers
9,School Totals,200,22,54,.407,12,35,.343,10,19,.526,8,12,.667,5,25,30,10,7,7,14,21,62,False,2305,Rutgers
12,School Totals,200,41,68,.603,30,46,.652,11,22,.500,23,30,.767,11,38,49,23,5,0,15,24,116,False,2306,Rutgers
10,School Totals,200,22,57,.386,15,37,.405,7,20,.350,21,29,.724,16,17,33,12,7,5,10,21,72,False,2307,Rutgers
11,School Totals,200,31,61,.508,18,34,.529,13,27,.481,12,14,.857,11,15,26,15,2,4,15,28,87,False,2308,Rutgers
11,School Totals,200,24,62,.387,18,43,.419,6,19,.316,17,25,.680,10,15,25,11,8,7,13,22,71,False,2309,Rutgers
11,School Totals,200,29,58,.500,22,39,.564,7,19,.368,8,12,.667,8,21,29,16,8,3,9,17,73,False,2310,Rutgers
10,School Totals,200,31,62,.500,22,42,.524,9,20,.450,18,25,.720,9,24,33,22,10,4,10,18,89,False,2311,Rutgers
11,School Totals,200,27,60,.450,25,47,.532,2,13,.154,19,31,.613,20,18,38,14,5,7,13,13,75,False,2312,Rutgers
11,School Totals,200,28,61,.459,24,50,.480,4,11,.364,11,14,.786,8,28,36,13,2,8,9,13,71,False,2313,Rutgers
10,School Totals,200,24,58,.414,20,40,.500,4,18,.222,24,32,.750,13,15,28,13,9,4,18,32,76,False,2314,Rutgers
12,School Totals,200,19,56,.339,17,41,.415,2,15,.133,11,21,.524,10,18,28,9,6,3,13,28,51,False,2315,Rutgers
12,School Totals,200,31,66,.470,21,44,.477,10,22,.455,13,18,.722,9,22,31,18,7,9,8,25,85,False,2316,Rutgers
13,School Totals,200,24,77,.312,23,67,.343,1,10,.100,6,10,.600,20,22,42,5,12,3,10,15,55,False,2317,Rutgers
13,School Totals,200,18,55,.327,13,38,.342,5,17,.294,15,19,.789,11,18,29,9,8,1,18,23,56,False,2318,Rutgers
11,School Totals,200,21,52,.404,13,34,.382,8,18,.444,21,25,.840,6,21,27,14,1,8,11,23,71,False,2319,Rutgers
11,School Totals,200,29,55,.527,19,38,.500,10,17,.588,14,17,.824,8,15,23,14,2,2,13,21,82,False,2320,Rutgers
12,School Totals,200,31,59,.525,24,42,.571,7,17,.412,24,31,.774,4,24,28,11,4,7,9,23,93,False,2321,Rutgers
13,School Totals,200,23,56,.411,18,37,.486,5,19,.263,18,33,.545,12,17,29,11,9,2,17,15,69,False,2322,Rutgers
10,School Totals,200,27,57,.474,23,43,.535,4,14,.286,21,26,.808,10,25,35,13,5,4,9,15,79,False,2323,Rutgers
11,School Totals,200,23,56,.411,20,42,.476,3,14,.214,16,24,.667,10,21,31,16,4,5,7,20,65,False,2324,Rutgers
13,School Totals,200,17,48,.354,12,28,.429,5,20,.250,15,23,.652,8,15,23,10,4,1,18,20,54,False,2325,Rutgers
10,School Totals,200,24,64,.375,20,44,.455,4,20,.200,7,11,.636,12,20,32,15,8,4,11,18,59,False,2326,Rutgers
11,School Totals,200,27,61,.443,21,43,.488,6,18,.333,5,10,.500,11,26,37,12,5,2,17,25,65,False,2327,Rutgers
10,School Totals,200,24,61,.393,18,42,.429,6,19,.316,20,22,.909,12,15,27,11,5,6,4,17,74,False,2328,Rutgers
11,School Totals,200,24,55,.436,16,37,.432,8,18,.444,7,11,.636,9,23,32,10,3,1,14,17,63,False,2329,Rutgers
11,School Totals,200,24,60,.400,17,39,.436,7,21,.333,11,16,.688,13,25,38,17,4,3,11,17,66,False,2330,Rutgers
9,School Totals,200,22,49,.449,18,36,.500,4,13,.308,24,30,.800,3,27,30,8,4,4,14,24,72,False,2331,Rutgers
13,School Totals,200,12,50,.240,9,34,.265,3,16,.188,4,8,.500,6,23,29,6,5,4,26,19,31,False,2332,Rutgers
11,School Totals,200,19,54,.352,15,36,.417,4,18,.222,11,18,.611,5,26,31,11,2,9,16,18,53,False,2333,Rutgers
12,School Totals,200,19,48,.396,15,36,.417,4,12,.333,19,25,.760,12,32,44,13,7,8,18,14,61,False,2334,Rutgers
12,School Totals,200,25,56,.446,17,40,.425,8,16,.500,18,27,.667,10,20,30,11,9,3,12,17,76,False,2335,Rutgers
11,School Totals,200,18,48,.375,13,24,.542,5,24,.208,9,18,.500,9,15,24,11,8,5,15,20,50,False,2336,Rutgers
11,School Totals,200,24,61,.393,17,38,.447,7,23,.304,13,19,.684,16,17,33,13,7,1,8,16,68,False,2337,Rutgers
11,School Totals,200,12,48,.250,12,35,.343,0,13,.000,2,3,.667,5,22,27,4,4,5,11,11,26,False,2338,Rutgers
10,School Totals,200,25,58,.431,18,39,.462,7,19,.368,12,16,.750,9,17,26,16,8,4,3,10,69,False,2339,Rutgers
12,School Totals,200,20,66,.303,17,53,.321,3,13,.231,11,16,.688,16,24,40,7,9,4,14,16,54,False,2340,Rutgers
9,School Totals,200,21,52,.404,16,37,.432,5,15,.333,13,18,.722,5,29,34,8,3,6,15,13,60,False,2341,Rutgers
10,School Totals,200,19,41,.463,17,35,.486,2,6,.333,23,25,.920,8,22,30,15,8,6,20,22,63,False,2342,Rutgers
9,School Totals,200,23,54,.426,13,36,.361,10,18,.556,12,16,.750,6,27,33,12,6,7,12,16,68,False,2343,Rutgers
15,School Totals,200,31,64,.484,26,43,.605,5,21,.238,12,21,.571,12,26,38,12,10,4,9,21,79,False,2344,Rutgers
10,School Totals,201,24,59,.407,18,37,.486,6,22,.273,5,8,.625,12,15,27,16,5,5,7,11,59,False,2345,Rutgers
10,School Totals,200,16,53,.302,11,35,.314,5,18,.278,10,16,.625,9,25,34,9,7,2,10,17,47,False,2346,Rutgers
10,School Totals,200,15,50,.300,12,37,.324,3,13,.231,17,28,.607,13,29,42,6,1,8,13,16,50,False,2013,Rutgers
14,School Totals,200,17,49,.347,15,36,.417,2,13,.154,13,23,.565,14,20,34,5,3,2,18,16,49,False,2347,Rutgers
10,School Totals,200,25,46,.543,20,35,.571,5,11,.455,12,15,.800,3,23,26,8,2,1,7,18,67,False,2348,Rutgers
10,School Totals,200,25,55,.455,18,38,.474,7,17,.412,8,16,.500,4,25,29,11,4,2,13,23,65,False,579,Rutgers
10,School Totals,200,30,59,.508,26,47,.553,4,12,.333,16,20,.800,12,22,34,14,6,2,19,17,80,False,2349,Rutgers
10,School Totals,200,19,53,.358,14,36,.389,5,17,.294,7,14,.500,11,22,33,8,4,3,11,17,50,False,969,Rutgers
13,School Totals,200,21,48,.438,18,35,.514,3,13,.231,6,14,.429,7,20,27,12,5,2,16,15,51,False,2015,Rutgers
11,School Totals,200,16,55,.291,12,40,.300,4,15,.267,15,22,.682,8,19,27,7,9,2,9,14,51,False,1351,Rutgers
10,School Totals,200,24,54,.444,17,37,.459,7,17,.412,9,12,.750,9,15,24,14,3,4,13,16,64,False,188,Rutgers
10,School Totals,200,21,50,.420,17,32,.531,4,18,.222,8,11,.727,6,18,24,11,4,3,14,11,54,False,2350,Rutgers
9,School Totals,200,20,69,.290,16,46,.348,4,23,.174,16,22,.727,17,19,36,13,8,3,12,19,60,False,1709,Rutgers
10,School Totals,200,18,54,.333,12,40,.300,6,14,.429,9,19,.474,10,24,34,7,4,4,14,21,51,False,2351,Rutgers
15,School Totals,200,18,55,.327,13,33,.394,5,22,.227,6,13,.462,10,21,31,10,6,2,19,18,47,False,2352,Rutgers
13,School Totals,200,20,54,.370,16,42,.381,4,12,.333,10,25,.400,8,20,28,12,6,2,12,17,54,False,194,Rutgers
11,School Totals,200,26,62,.419,21,46,.457,5,16,.313,28,34,.824,7,20,27,12,7,1,11,26,85,False,2353,Rutgers
10,School Totals,200,19,59,.322,15,44,.341,4,15,.267,8,13,.615,19,20,39,9,6,5,12,16,50,False,589,Rutgers
12,School Totals,200,30,57,.526,26,43,.605,4,14,.286,5,8,.625,6,24,30,15,1,2,12,12,69,False,978,Rutgers
11,School Totals,200,27,60,.450,22,45,.489,5,15,.333,9,15,.600,11,24,35,11,6,1,14,16,68,False,2354,Rutgers
12,School Totals,200,30,60,.500,25,42,.595,5,18,.278,7,12,.583,14,26,40,18,6,9,20,27,72,False,2355,Rutgers
11,School Totals,200,24,56,.429,22,42,.524,2,14,.143,32,46,.696,13,25,38,18,11,2,20,25,82,False,2356,Rutgers
10,School Totals,200,25,60,.417,21,50,.420,4,10,.400,5,14,.357,5,28,33,9,9,5,11,22,59,False,2357,Rutgers
11,School Totals,200,29,57,.509,24,45,.533,5,12,.417,24,34,.706,11,23,34,10,8,6,14,14,87,False,2358,Rutgers
13,School Totals,200,29,67,.433,23,51,.451,6,16,.375,11,15,.733,10,21,31,12,8,1,15,19,75,False,2359,Rutgers
12,School Totals,200,22,47,.468,20,38,.526,2,9,.222,12,18,.667,2,18,20,9,3,0,15,18,58,False,2360,Rutgers
11,School Totals,200,27,74,.365,24,59,.407,3,15,.200,11,18,.611,10,26,36,6,7,6,9,22,68,False,2361,Rutgers
13,School Totals,200,20,60,.333,15,41,.366,5,19,.263,10,16,.625,6,23,29,9,8,8,13,19,55,False,2362,Rutgers
13,School Totals,200,28,57,.491,22,44,.500,6,13,.462,13,17,.765,6,27,33,18,8,2,12,14,75,False,2363,Rutgers
13,School Totals,200,18,53,.340,13,34,.382,5,19,.263,8,10,.800,8,29,37,7,3,5,22,12,49,False,2364,Rutgers
9,School Totals,200,19,63,.302,12,41,.293,7,22,.318,22,30,.733,12,23,35,11,1,8,9,16,67,False,2365,Rutgers
9,School Totals,200,21,46,.457,14,29,.483,7,17,.412,23,31,.742,7,35,42,10,5,4,17,19,72,False,2366,Rutgers
12,School Totals,200,36,67,.537,26,51,.510,10,16,.625,7,17,.412,14,31,45,17,5,2,10,14,89,False,2367,Rutgers
9,School Totals,200,28,64,.438,22,49,.449,6,15,.400,10,11,.909,10,18,28,11,14,0,17,19,72,False,214,Rutgers
11,School Totals,200,23,58,.397,18,46,.391,5,12,.417,6,6,1.000,4,19,23,10,2,1,10,16,57,False,2368,Rutgers
11,School Totals,200,22,57,.386,15,39,.385,7,18,.389,12,17,.706,6,19,25,11,7,2,10,20,63,False,608,Rutgers
11,School Totals,200,17,51,.333,15,34,.441,2,17,.118,20,28,.714,8,16,24,8,4,2,12,12,56,False,2369,Rutgers
11,School Totals,200,22,57,.386,16,37,.432,6,20,.300,18,28,.643,6,25,31,9,4,3,14,18,68,False,1734,Rutgers
10,School Totals,200,22,58,.379,20,42,.476,2,16,.125,11,18,.611,5,17,22,9,2,4,7,18,57,False,2370,Rutgers
9,School Totals,200,31,64,.484,27,47,.574,4,17,.235,10,13,.769,8,24,32,17,4,4,11,18,76,False,2371,Rutgers
8,School Totals,200,22,50,.440,19,32,.594,3,18,.167,10,14,.714,2,24,26,11,6,0,13,18,57,False,1000,Rutgers
10,School Totals,200,24,65,.369,17,46,.370,7,19,.368,7,10,.700,2,21,23,13,4,3,9,15,62,False,1387,Rutgers
9,School Totals,275,39,85,.459,31,60,.517,8,25,.320,15,23,.652,15,34,49,18,6,6,19,27,101,False,2372,Rutgers
11,School Totals,200,24,58,.414,19,46,.413,5,12,.417,10,14,.714,8,23,31,11,7,2,13,15,63,False,2373,Rutgers
8,School Totals,200,25,65,.385,22,45,.489,3,20,.150,16,25,.640,10,20,30,8,10,3,11,16,69,False,1740,Rutgers
9,School Totals,200,25,57,.439,20,40,.500,5,17,.294,11,18,.611,5,21,26,15,5,3,15,21,66,False,2374,Rutgers
10,School Totals,200,21,54,.389,19,43,.442,2,11,.182,14,19,.737,6,28,34,9,7,4,9,12,58,False,2046,Rutgers
10,School Totals,200,22,54,.407,17,47,.362,5,7,.714,12,22,.545,6,25,31,8,8,6,20,19,61,False,2375,Rutgers
12,School Totals,200,16,47,.340,10,30,.333,6,17,.353,21,30,.700,5,17,22,13,2,3,10,13,59,False,2376,Rutgers
10,School Totals,200,24,52,.462,21,40,.525,3,12,.250,15,22,.682,2,12,14,13,3,4,14,13,66,False,1392,Rutgers
12,School Totals,200,26,59,.441,18,44,.409,8,15,.533,15,22,.682,14,29,43,14,14,3,16,14,75,False,2377,Rutgers
11,School Totals,200,24,56,.429,17,41,.415,7,15,.467,17,22,.773,9,21,30,15,4,2,17,17,72,False,2378,Rutgers
16,School Totals,201,29,60,.483,22,38,.579,7,22,.318,21,36,.583,15,27,42,17,13,4,11,21,86,False,2379,Rutgers
14,School Totals,200,30,68,.441,22,47,.468,8,21,.381,19,27,.704,18,28,46,18,3,6,17,15,87,False,2380,Rutgers
11,School Totals,200,20,51,.392,17,39,.436,3,12,.250,23,29,.793,15,24,39,6,5,4,15,21,66,False,2381,Rutgers
11,School Totals,200,30,64,.469,23,45,.511,7,19,.368,11,14,.786,12,28,40,16,5,11,11,21,78,False,2382,Rutgers
11,School Totals,200,23,63,.365,20,43,.465,3,20,.150,17,22,.773,18,29,47,16,4,8,11,11,66,False,2383,Rutgers
10,School Totals,200,27,60,.450,21,42,.500,6,18,.333,17,30,.567,16,21,37,18,10,4,15,13,77,False,2384,Rutgers
12,School Totals,200,23,63,.365,20,47,.426,3,16,.188,12,16,.750,9,15,24,9,12,2,9,18,61,False,2385,Rutgers
11,School Totals,200,25,67,.373,23,51,.451,2,16,.125,20,27,.741,14,32,46,10,6,8,8,15,72,False,2386,Rutgers
15,School Totals,200,35,54,.648,31,44,.705,4,10,.400,5,13,.385,4,31,35,24,14,8,15,16,79,False,2387,Rutgers
12,School Totals,200,26,53,.491,20,35,.571,6,18,.333,13,18,.722,6,27,33,8,7,2,13,15,71,False,2388,Rutgers
11,School Totals,200,31,60,.517,25,44,.568,6,16,.375,14,29,.483,16,25,41,16,3,3,8,16,82,False,2389,Rutgers
11,School Totals,200,28,57,.491,24,48,.500,4,9,.444,8,13,.615,15,34,49,17,2,6,17,12,68,False,2390,Rutgers
11,School Totals,200,18,50,.360,15,40,.375,3,10,.300,22,28,.786,4,30,34,7,7,8,19,28,61,False,2391,Rutgers
13,School Totals,200,19,61,.311,12,43,.279,7,18,.389,7,11,.636,15,17,32,6,6,4,15,22,52,False,2392,Rutgers
12,School Totals,200,18,63,.286,15,43,.349,3,20,.150,8,13,.615,10,30,40,6,6,4,17,17,47,False,2064,Rutgers
13,School Totals,200,25,60,.417,22,52,.423,3,8,.375,12,27,.444,13,16,29,7,8,3,13,20,65,False,1412,Rutgers
12,School Totals,200,28,73,.384,24,58,.414,4,15,.267,2,4,.500,16,22,38,13,10,3,17,22,62,False,2393,Rutgers
12,School Totals,200,22,69,.319,21,57,.368,1,12,.083,15,23,.652,21,20,41,10,5,8,8,17,60,False,2394,Rutgers
13,School Totals,200,22,50,.440,21,44,.477,1,6,.167,12,26,.462,10,26,36,5,0,5,21,17,57,False,253,Rutgers
10,School Totals,200,24,52,.462,21,46,.457,3,6,.500,14,20,.700,7,28,35,8,6,11,12,13,65,False,2395,Rutgers
12,School Totals,200,21,62,.339,18,51,.353,3,11,.273,10,24,.417,17,16,33,9,8,6,15,15,55,False,647,Rutgers
11,School Totals,225,19,54,.352,16,44,.364,3,10,.300,13,20,.650,5,28,33,6,8,4,16,25,54,False,2396,Rutgers
13,School Totals,200,25,64,.391,21,49,.429,4,15,.267,9,14,.643,16,24,40,16,6,6,17,16,63,False,2397,Rutgers
12,School Totals,200,25,54,.463,18,38,.474,7,16,.438,13,23,.565,12,24,36,9,8,2,15,18,70,False,2069,Rutgers
11,School Totals,200,25,63,.397,21,46,.457,4,17,.235,10,18,.556,12,23,35,10,9,2,10,22,64,False,1767,Rutgers
11,School Totals,200,25,60,.417,22,46,.478,3,14,.214,10,22,.455,11,19,30,11,7,4,9,18,63,False,2398,Rutgers
12,School Totals,200,23,64,.359,15,44,.341,8,20,.400,1,3,.333,7,17,24,8,9,1,12,17,55,False,2399,Rutgers
11,School Totals,200,27,63,.429,22,46,.478,5,17,.294,6,12,.500,16,20,36,10,6,2,8,18,65,False,2400,Rutgers
11,School Totals,200,24,59,.407,18,43,.419,6,16,.375,10,13,.769,9,23,32,9,8,1,7,18,64,False,1037,Rutgers
11,School Totals,200,24,58,.414,20,41,.488,4,17,.235,7,12,.583,15,15,30,7,3,3,12,15,59,False,657,Rutgers
13,School Totals,200,23,53,.434,18,38,.474,5,15,.333,11,13,.846,8,28,36,10,5,1,10,14,62,False,2401,Rutgers
11,School Totals,200,23,62,.371,16,39,.410,7,23,.304,13,19,.684,17,27,44,8,4,3,13,17,66,False,1771,Rutgers
14,School Totals,200,22,53,.415,13,34,.382,9,19,.474,8,12,.667,6,11,17,10,4,6,11,21,61,False,2402,Rutgers
14,School Totals,200,38,62,.613,36,45,.800,2,17,.118,16,32,.500,16,42,58,17,14,2,14,12,94,False,2403,Rutgers
11,School Totals,200,23,65,.354,19,50,.380,4,15,.267,21,27,.778,15,23,38,13,9,5,12,13,71,False,2404,Rutgers
11,School Totals,200,29,65,.446,22,41,.537,7,24,.292,5,11,.455,10,32,42,14,5,3,8,13,70,False,2405,Rutgers
14,School Totals,200,24,66,.364,22,49,.449,2,17,.118,14,28,.500,16,34,50,10,3,7,8,12,64,False,2406,Rutgers
14,School Totals,200,33,68,.485,25,46,.543,8,22,.364,9,16,.563,14,25,39,15,11,16,9,13,83,False,2407,Rutgers
11,School Totals,200,20,62,.323,15,48,.313,5,14,.357,14,23,.609,16,22,38,11,9,4,7,14,59,False,2408,Rutgers
11,School Totals,200,26,64,.406,21,47,.447,5,17,.294,16,20,.800,12,22,34,7,3,2,13,24,73,False,2409,Rutgers
11,School Totals,200,24,74,.324,19,56,.339,5,18,.278,14,18,.778,13,23,36,11,7,8,14,24,67,False,2410,Rutgers
11,School Totals,200,17,66,.258,13,51,.255,4,15,.267,14,18,.778,17,22,39,7,3,5,10,21,52,False,1436,Rutgers
11,School Totals,200,29,50,.580,26,42,.619,3,8,.375,12,23,.522,9,29,38,9,8,9,19,16,73,False,2411,Rutgers
15,School Totals,200,33,62,.532,26,45,.578,7,17,.412,19,28,.679,11,34,45,18,10,4,12,16,92,False,2412,Rutgers
10,School Totals,200,32,65,.492,30,57,.526,2,8,.250,9,14,.643,13,30,43,16,8,5,14,16,75,False,2413,Rutgers
10,School Totals,200,23,67,.343,20,55,.364,3,12,.250,22,34,.647,19,25,44,8,10,6,8,15,71,False,2414,Rutgers
11,School Totals,225,29,65,.446,22,47,.468,7,18,.389,8,19,.421,12,24,36,13,8,9,14,19,73,False,2415,Rutgers
11,School Totals,200,20,58,.345,14,40,.350,6,18,.333,12,22,.545,12,19,31,7,10,5,6,17,58,False,2416,Rutgers
11,School Totals,200,20,60,.333,18,47,.383,2,13,.154,9,16,.563,6,17,23,6,9,3,11,25,51,False,2417,Rutgers
10,School Totals,200,25,54,.463,20,46,.435,5,8,.625,9,16,.563,7,21,28,12,5,1,6,17,64,False,2418,Rutgers
11,School Totals,225,27,67,.403,22,49,.449,5,18,.278,13,15,.867,9,30,39,12,6,1,9,29,72,False,1444,Rutgers
11,School Totals,200,17,59,.288,11,41,.268,6,18,.333,6,11,.545,9,20,29,6,4,4,5,10,46,False,1787,Rutgers
12,School Totals,200,29,54,.537,22,38,.579,7,16,.438,15,20,.750,9,22,31,18,9,1,11,16,80,False,2419,Rutgers
12,School Totals,200,17,51,.333,15,42,.357,2,9,.222,11,15,.733,7,24,31,1,4,1,13,18,47,False,1067,Rutgers
12,School Totals,200,22,65,.338,20,53,.377,2,12,.167,8,13,.615,18,21,39,5,6,1,13,20,54,False,2420,Rutgers
11,School Totals,200,16,51,.314,12,34,.353,4,17,.235,7,9,.778,1,24,25,10,7,3,15,15,43,False,2095,Rutgers
13,School Totals,200,19,45,.422,14,31,.452,5,14,.357,17,24,.708,8,16,24,6,10,1,25,21,60,False,2421,Rutgers
12,School Totals,200,31,64,.484,25,52,.481,6,12,.500,8,10,.800,13,22,35,7,3,5,10,22,76,False,2422,Rutgers
12,School Totals,200,13,54,.241,9,40,.225,4,14,.286,13,24,.542,13,24,37,5,6,5,11,17,43,False,294,Rutgers
14,School Totals,200,24,69,.348,22,55,.400,2,14,.143,5,8,.625,19,21,40,6,9,1,9,15,55,False,2423,Rutgers
10,School Totals,225,24,60,.400,19,41,.463,5,19,.263,14,18,.778,11,27,38,11,8,5,8,12,67,False,2424,Rutgers
11,School Totals,200,22,58,.379,19,39,.487,3,19,.158,4,7,.571,12,19,31,10,6,2,12,16,51,False,688,Rutgers
12,School Totals,200,22,54,.407,20,42,.476,2,12,.167,6,12,.500,8,16,24,10,8,3,9,10,52,False,1796,Rutgers
11,School Totals,200,19,44,.432,16,30,.533,3,14,.214,21,31,.677,9,19,28,11,6,4,16,21,62,False,2425,Rutgers
10,School Totals,200,22,56,.393,19,47,.404,3,9,.333,18,25,.720,14,33,47,6,4,2,12,18,65,False,2426,Rutgers
10,School Totals,200,29,50,.580,25,42,.595,4,8,.500,14,18,.778,2,24,26,6,8,1,11,19,76,False,300,Rutgers
10,School Totals,200,32,68,.471,27,54,.500,5,14,.357,6,10,.600,16,19,35,9,4,2,9,17,75,False,2427,Rutgers
13,School Totals,200,35,65,.538,23,45,.511,12,20,.600,8,17,.471,15,26,41,22,6,12,17,15,90,False,2428,Rutgers
13,School Totals,200,33,63,.524,19,37,.514,14,26,.538,15,26,.577,12,28,40,19,7,8,14,17,95,False,2429,Rutgers
11,School Totals,200,22,63,.349,15,37,.405,7,26,.269,14,25,.560,13,26,39,12,4,2,14,16,65,False,2430,Rutgers
13,School Totals,200,24,56,.429,14,32,.438,10,24,.417,5,8,.625,10,27,37,20,10,5,20,17,63,False,2431,Rutgers
10,School Totals,200,18,56,.321,13,34,.382,5,22,.227,13,22,.591,13,30,43,5,7,2,16,15,54,False,2432,Rutgers
11,School Totals,200,24,59,.407,18,35,.514,6,24,.250,3,6,.500,8,31,39,10,8,8,14,13,57,False,2433,Rutgers
12,School Totals,200,24,65,.369,16,39,.410,8,26,.308,11,16,.688,12,20,32,6,3,2,7,19,67,False,1464,Rutgers
11,School Totals,200,27,58,.466,22,42,.524,5,16,.313,5,6,.833,4,21,25,10,3,2,8,19,64,False,2434,Rutgers
11,School Totals,200,26,61,.426,22,45,.489,4,16,.250,14,20,.700,13,22,35,11,4,3,10,22,70,False,2435,Rutgers
11,School Totals,200,25,79,.316,19,50,.380,6,29,.207,10,15,.667,19,25,44,13,10,5,10,26,66,False,2436,Rutgers
11,School Totals,225,24,62,.387,22,43,.512,2,19,.105,18,26,.692,17,24,41,10,11,7,18,15,68,False,2437,Rutgers
12,School Totals,200,23,56,.411,15,26,.577,8,30,.267,16,24,.667,17,21,38,20,7,1,9,18,70,False,2438,Rutgers
11,School Totals,200,23,62,.371,17,41,.415,6,21,.286,11,17,.647,8,26,34,13,6,5,11,20,63,False,706,Rutgers
10,School Totals,200,22,53,.415,17,37,.459,5,16,.313,15,20,.750,9,22,31,10,7,6,9,16,64,False,1813,Rutgers
11,School Totals,200,28,67,.418,24,49,.490,4,18,.222,10,16,.625,13,22,35,12,3,1,11,17,70,False,2439,Rutgers
10,School Totals,200,18,48,.375,11,28,.393,7,20,.350,11,18,.611,7,20,27,9,4,3,19,13,54,False,2440,Rutgers
10,School Totals,200,19,49,.388,15,32,.469,4,17,.235,15,25,.600,7,26,33,10,8,3,12,20,57,False,2441,Rutgers
11,School Totals,200,27,61,.443,22,48,.458,5,13,.385,17,26,.654,14,29,43,10,8,5,15,19,76,False,2442,Rutgers
10,School Totals,200,21,60,.350,14,44,.318,7,16,.438,15,21,.714,11,26,37,9,9,0,12,21,64,False,2122,Rutgers
10,School Totals,200,23,56,.411,18,44,.409,5,12,.417,15,24,.625,12,31,43,13,5,7,14,17,66,False,321,Rutgers
11,School Totals,200,24,55,.436,18,36,.500,6,19,.316,8,17,.471,14,17,31,14,4,2,12,14,62,False,1817,Rutgers
11,School Totals,200,24,58,.414,19,46,.413,5,12,.417,12,16,.750,9,25,34,12,4,4,9,18,65,False,1106,Rutgers
10,School Totals,225,37,73,.507,30,50,.600,7,23,.304,13,21,.619,11,30,41,17,7,5,15,22,94,False,2443,Rutgers
11,School Totals,200,24,58,.414,21,42,.500,3,16,.188,8,15,.533,9,31,40,10,5,1,14,16,59,False,2444,Rutgers
11,School Totals,200,26,57,.456,19,37,.514,7,20,.350,10,18,.556,13,18,31,14,10,2,11,18,69,False,2445,Rutgers
10,School Totals,200,23,58,.397,18,38,.474,5,20,.250,9,17,.529,9,18,27,12,7,4,9,17,60,False,1481,Rutgers
11,School Totals,200,25,56,.446,20,42,.476,5,14,.357,13,19,.684,6,24,30,6,7,4,8,16,68,False,2446,Rutgers
11,School Totals,200,30,59,.508,19,36,.528,11,23,.478,15,26,.577,9,25,34,21,8,1,10,27,86,False,2447,Rutgers
11,School Totals,200,25,66,.379,21,42,.500,4,24,.167,11,16,.688,13,28,41,13,10,8,11,15,65,False,2129,Rutgers
11,School Totals,200,23,54,.426,19,40,.475,4,14,.286,23,30,.767,11,23,34,9,3,2,12,23,73,False,331,Rutgers
11,School Totals,200,24,49,.490,20,33,.606,4,16,.250,9,11,.818,6,27,33,18,6,4,21,25,61,False,2448,Rutgers
11,School Totals,200,26,69,.377,23,43,.535,3,26,.115,18,32,.563,11,31,42,15,11,7,15,13,73,False,2449,Rutgers
15,School Totals,200,35,59,.593,26,40,.650,9,19,.474,7,8,.875,7,28,35,22,7,6,9,12,86,False,2450,Rutgers
11,School Totals,200,19,51,.373,15,34,.441,4,17,.235,20,25,.800,7,30,37,8,7,8,13,13,62,False,2451,Rutgers
12,School Totals,200,24,56,.429,17,31,.548,7,25,.280,19,30,.633,18,17,35,18,4,5,13,16,74,False,2452,Rutgers
11,School Totals,200,22,45,.489,14,25,.560,8,20,.400,17,28,.607,6,25,31,12,9,7,19,22,69,False,2453,Rutgers
14,School Totals,200,35,60,.583,30,46,.652,5,14,.357,10,17,.588,8,24,32,22,4,4,10,16,85,False,2454,Rutgers
11,School Totals,200,31,58,.534,28,45,.622,3,13,.231,17,24,.708,9,28,37,12,11,5,14,18,82,False,2455,Rutgers
10,School Totals,200,25,60,.417,21,37,.568,4,23,.174,6,10,.600,16,24,40,9,6,2,20,20,60,False,2456,Rutgers
11,School Totals,200,24,60,.400,20,46,.435,4,14,.286,13,19,.684,6,22,28,14,3,2,11,23,65,False,1498,Rutgers
11,School Totals,200,29,63,.460,24,44,.545,5,19,.263,9,13,.692,11,23,34,10,8,3,11,19,72,False,2457,Rutgers
13,School Totals,200,27,58,.466,19,39,.487,8,19,.421,6,9,.667,9,35,44,19,9,8,18,13,68,False,2458,Rutgers
14,School Totals,200,30,63,.476,29,54,.537,1,9,.111,2,6,.333,12,30,42,10,14,3,18,12,63,False,2459,Rutgers
14,School Totals,200,36,69,.522,26,46,.565,10,23,.435,12,19,.632,16,31,47,17,7,5,12,17,94,False,2460,Rutgers
9,School Totals,200,34,63,.540,29,48,.604,5,15,.333,6,12,.500,15,29,44,16,3,4,11,16,79,False,2461,Rutgers
9,School Totals,200,24,58,.414,22,48,.458,2,10,.200,22,29,.759,8,31,39,9,7,9,10,13,72,False,2144,Rutgers
10,School Totals,200,20,59,.339,12,36,.333,8,23,.348,3,8,.375,10,30,40,8,5,3,11,17,51,False,2462,Rutgers
10,School Totals,200,23,49,.469,19,34,.559,4,15,.267,9,18,.500,5,29,34,14,6,6,13,14,59,False,352,Rutgers
11,School Totals,200,24,61,.393,18,48,.375,6,13,.462,10,17,.588,17,25,42,10,5,1,6,12,64,False,2463,Rutgers
11,School Totals,200,29,63,.460,22,42,.524,7,21,.333,15,21,.714,8,20,28,17,5,0,9,21,80,False,2464,Rutgers
10,School Totals,200,28,62,.452,20,40,.500,8,22,.364,11,17,.647,9,31,40,15,6,7,12,14,75,False,2465,Rutgers
10,School Totals,200,20,44,.455,15,28,.536,5,16,.313,25,36,.694,5,22,27,13,9,4,14,15,70,False,2466,Rutgers
11,School Totals,200,27,83,.325,21,59,.356,6,24,.250,3,5,.600,20,23,43,6,8,4,9,21,63,False,1139,Rutgers
9,School Totals,200,22,65,.338,19,48,.396,3,17,.176,4,6,.667,8,32,40,8,7,5,8,20,51,False,744,Rutgers
10,School Totals,225,26,57,.456,22,37,.595,4,20,.200,21,34,.618,16,28,44,12,1,6,11,13,77,False,2467,Rutgers
11,School Totals,200,22,48,.458,13,27,.481,9,21,.429,13,18,.722,5,23,28,8,4,2,11,20,66,False,1846,Rutgers
10,School Totals,200,27,55,.491,20,40,.500,7,15,.467,11,12,.917,8,28,36,15,5,9,9,16,72,False,2468,Rutgers
10,School Totals,200,22,63,.349,19,45,.422,3,18,.167,5,9,.556,12,21,33,7,5,2,9,17,52,False,1143,Rutgers
11,School Totals,200,30,60,.500,26,46,.565,4,14,.286,7,10,.700,7,25,32,13,8,2,10,21,71,False,2469,Rutgers
11,School Totals,200,27,64,.422,23,49,.469,4,15,.267,6,11,.545,9,28,37,9,10,4,10,19,64,False,2152,Rutgers
11,School Totals,200,30,61,.492,23,45,.511,7,16,.438,11,20,.550,7,30,37,17,4,5,7,18,78,False,752,Rutgers
11,School Totals,225,27,61,.443,18,43,.419,9,18,.500,8,14,.571,10,29,39,9,5,4,15,19,71,False,2470,Rutgers
14,School Totals,200,40,66,.606,39,58,.672,1,8,.125,5,15,.333,12,32,44,23,10,4,9,13,86,False,2471,Rutgers
12,School Totals,200,37,65,.569,30,46,.652,7,19,.368,15,25,.600,12,28,40,18,12,9,15,13,96,False,2472,Rutgers
10,School Totals,200,24,55,.436,20,41,.488,4,14,.286,18,29,.621,8,37,45,17,8,7,15,16,70,False,2473,Rutgers
10,School Totals,200,28,58,.483,19,34,.559,9,24,.375,14,18,.778,12,28,40,19,6,2,17,17,79,False,2474,Rutgers
9,School Totals,200,29,60,.483,20,41,.488,9,19,.474,7,16,.438,7,28,35,18,5,5,8,18,74,False,759,Rutgers
8,School Totals,200,29,62,.468,21,42,.500,8,20,.400,25,36,.694,13,20,33,12,8,8,9,17,91,False,2475,Rutgers
9,School Totals,200,24,58,.414,14,33,.424,10,25,.400,10,17,.588,3,20,23,12,3,3,9,21,68,False,1858,Rutgers
10,School Totals,200,28,56,.500,17,35,.486,11,21,.524,14,17,.824,4,23,27,12,7,3,5,17,81,False,2476,Rutgers
10,School Totals,200,31,71,.437,22,48,.458,9,23,.391,4,12,.333,15,21,36,19,11,8,10,21,75,False,2477,Rutgers
12,School Totals,200,18,59,.305,15,47,.319,3,12,.250,6,17,.353,6,15,21,10,13,4,6,16,45,False,1526,Rutgers
11,School Totals,200,29,66,.439,24,46,.522,5,20,.250,5,10,.500,8,19,27,13,8,3,5,22,68,False,1862,Rutgers
9,School Totals,200,25,67,.373,23,48,.479,2,19,.105,2,7,.286,17,30,47,6,6,4,12,19,54,False,2478,Rutgers
11,School Totals,200,27,61,.443,20,44,.455,7,17,.412,6,11,.545,7,19,26,18,8,2,12,18,67,False,2162,Rutgers
9,School Totals,200,27,53,.509,19,31,.613,8,22,.364,12,17,.706,5,25,30,15,8,7,8,16,74,False,383,Rutgers
14,School Totals,200,26,60,.433,21,41,.512,5,19,.263,10,12,.833,13,27,40,12,14,7,12,14,67,False,1528,Rutgers
9,School Totals,200,23,47,.489,18,25,.720,5,22,.227,13,22,.591,4,23,27,12,8,4,18,20,64,False,2479,Rutgers
9,School Totals,200,26,49,.531,20,34,.588,6,15,.400,18,25,.720,10,24,34,13,8,7,13,16,76,False,2480,Rutgers
14,School Totals,200,28,64,.438,22,36,.611,6,28,.214,4,6,.667,10,19,29,18,6,4,9,20,66,False,2481,Rutgers
9,School Totals,200,23,56,.411,19,37,.514,4,19,.211,14,16,.875,8,33,41,9,6,8,12,13,64,False,2482,Rutgers
9,School Totals,200,25,62,.403,22,50,.440,3,12,.250,11,18,.611,7,19,26,8,4,7,2,16,64,False,1161,Rutgers
10,School Totals,200,21,55,.382,16,33,.485,5,22,.227,12,14,.857,7,23,30,10,6,2,14,22,59,False,776,Rutgers
14,School Totals,200,30,61,.492,19,33,.576,11,28,.393,3,6,.500,6,31,37,22,9,10,13,16,74,False,390,Rutgers
13,School Totals,200,22,57,.386,19,34,.559,3,23,.130,4,6,.667,6,22,28,6,6,6,13,13,51,False,2483,Rutgers
9,School Totals,225,27,62,.435,19,42,.452,8,20,.400,15,24,.625,6,32,38,14,10,3,14,23,77,False,2484,Rutgers
9,School Totals,200,24,60,.400,18,37,.486,6,23,.261,7,9,.778,10,28,38,16,4,4,10,18,61,False,394,Rutgers
14,School Totals,200,25,54,.463,23,43,.535,2,11,.182,16,22,.727,2,16,18,7,9,5,11,24,68,False,2485,Rutgers
9,School Totals,200,23,58,.397,15,28,.536,8,30,.267,6,9,.667,12,24,36,11,6,5,13,13,60,False,2486,Rutgers
9,School Totals,200,22,50,.440,15,34,.441,7,16,.438,9,12,.750,6,21,27,14,4,3,13,18,60,False,2487,Rutgers
13,School Totals,200,36,65,.554,30,47,.638,6,18,.333,18,26,.692,13,28,41,22,3,6,9,20,96,False,2488,Illinois
13,School Totals,200,27,62,.435,23,49,.469,4,13,.308,22,30,.733,10,26,36,15,7,10,14,16,80,False,2489,Illinois
14,School Totals,200,39,72,.542,28,46,.609,11,26,.423,5,7,.714,19,28,47,27,7,4,9,14,94,False,2490,Illinois
13,School Totals,200,28,49,.571,20,35,.571,8,14,.571,14,22,.636,4,24,28,19,5,3,8,16,78,False,2491,Illinois
12,School Totals,200,23,59,.390,22,50,.440,1,9,.111,11,13,.846,5,24,29,10,5,1,10,19,58,False,2492,Illinois
11,School Totals,200,25,63,.397,21,45,.467,4,18,.222,14,15,.933,13,30,43,11,5,1,15,15,68,False,2493,Illinois
11,School Totals,200,28,54,.519,22,40,.550,6,14,.429,14,22,.636,13,22,35,17,5,8,14,20,76,False,2494,Illinois
12,School Totals,200,32,66,.485,23,48,.479,9,18,.500,11,16,.688,13,15,28,17,10,2,16,16,84,False,2495,Illinois
10,School Totals,200,32,54,.593,24,39,.615,8,15,.533,7,13,.538,5,23,28,20,5,5,14,13,79,False,2496,Illinois
14,School Totals,200,34,70,.486,28,54,.519,6,16,.375,14,15,.933,9,36,45,20,10,7,11,16,88,False,2497,Illinois
11,School Totals,200,27,60,.450,22,45,.489,5,15,.333,8,10,.800,7,19,26,14,5,5,8,16,67,False,2498,Illinois
12,School Totals,200,27,68,.397,22,50,.440,5,18,.278,9,14,.643,19,25,44,13,9,2,21,14,68,False,2499,Illinois
10,School Totals,225,31,62,.500,26,47,.553,5,15,.333,22,27,.815,8,35,43,21,2,3,11,14,89,False,2500,Illinois
10,School Totals,225,34,82,.415,30,58,.517,4,24,.167,11,14,.786,11,19,30,23,15,2,10,18,83,False,2501,Illinois
13,School Totals,200,23,56,.411,17,41,.415,6,15,.400,7,9,.778,10,20,30,18,7,2,10,16,59,False,2502,Illinois
9,School Totals,200,18,46,.391,15,33,.455,3,13,.231,27,39,.692,8,26,34,13,9,5,11,17,66,False,14,Illinois
10,School Totals,200,21,54,.389,13,39,.333,8,15,.533,4,6,.667,4,22,26,14,4,7,10,8,54,False,1890,Illinois
11,School Totals,200,22,63,.349,16,38,.421,6,25,.240,13,16,.813,11,19,30,13,7,1,17,19,63,False,1189,Illinois
10,School Totals,200,27,66,.409,20,48,.417,7,18,.389,17,29,.586,14,16,30,13,5,5,13,25,78,False,2503,Illinois
10,School Totals,200,26,47,.553,20,31,.645,6,16,.375,10,15,.667,4,23,27,16,3,4,15,26,68,False,2504,Illinois
10,School Totals,200,25,48,.521,16,30,.533,9,18,.500,18,25,.720,5,28,33,18,2,4,8,18,77,False,1893,Illinois
10,School Totals,200,25,51,.490,21,39,.538,4,12,.333,18,25,.720,10,19,29,16,4,6,14,22,72,False,19,Illinois
10,School Totals,200,21,47,.447,17,32,.531,4,15,.267,11,16,.688,4,22,26,12,4,3,10,11,57,False,2505,Illinois
10,School Totals,200,31,59,.525,23,41,.561,8,18,.444,8,14,.571,7,14,21,17,6,4,9,13,78,False,1194,Illinois
10,School Totals,200,24,45,.533,20,34,.588,4,11,.364,11,15,.733,5,27,32,8,4,3,10,15,63,False,2506,Illinois
13,School Totals,200,23,67,.343,19,43,.442,4,24,.167,3,6,.500,15,21,36,13,9,1,12,15,53,False,1560,Illinois
10,School Totals,200,27,55,.491,19,39,.487,8,16,.500,3,5,.600,5,20,25,21,1,6,14,22,65,False,2507,Illinois
10,School Totals,200,19,51,.373,15,34,.441,4,17,.235,9,15,.600,12,37,49,12,2,2,16,9,51,False,808,Illinois
10,School Totals,200,23,72,.319,14,36,.389,9,36,.250,5,6,.833,16,21,37,14,4,3,7,21,60,False,2508,Illinois
13,School Totals,200,23,60,.383,16,37,.432,7,23,.304,4,5,.800,9,21,30,14,3,5,9,19,57,False,1563,Illinois
12,School Totals,200,16,45,.356,11,29,.379,5,16,.313,20,23,.870,8,21,29,9,1,5,8,18,57,False,2509,Illinois
10,School Totals,200,21,40,.525,15,30,.500,6,10,.600,10,17,.588,2,33,35,12,3,4,17,16,58,False,2510,Illinois
9,School Totals,250,31,75,.413,21,45,.467,10,30,.333,9,10,.900,13,29,42,18,13,4,16,21,81,False,1564,Illinois
9,School Totals,200,27,51,.529,17,29,.586,10,22,.455,12,15,.800,7,26,33,17,6,3,17,14,76,False,2511,Illinois
13,School Totals,200,32,66,.485,29,50,.580,3,16,.188,8,12,.667,12,26,38,19,5,5,7,15,75,False,2512,Illinois
10,School Totals,200,29,77,.377,23,51,.451,6,26,.231,7,14,.500,16,22,38,14,7,3,10,22,71,False,2513,Illinois
13,School Totals,200,29,58,.500,21,34,.618,8,24,.333,13,23,.565,8,30,38,17,9,8,14,22,79,False,2514,Illinois
12,School Totals,200,37,64,.578,32,46,.696,5,18,.278,5,6,.833,10,28,38,21,10,7,14,18,84,False,2515,Illinois
13,School Totals,200,32,58,.552,26,45,.578,6,13,.462,15,19,.789,7,24,31,22,6,6,16,17,85,False,2516,Illinois
11,School Totals,225,28,73,.384,18,44,.409,10,29,.345,18,28,.643,13,24,37,10,4,7,12,29,84,False,2517,Illinois
11,School Totals,200,28,60,.467,18,41,.439,10,19,.526,14,23,.609,7,19,26,22,8,3,11,19,80,False,431,Illinois
14,School Totals,200,31,63,.492,27,52,.519,4,11,.364,7,14,.500,11,26,37,17,10,4,16,16,73,False,2518,Illinois
14,School Totals,200,33,64,.516,29,51,.569,4,13,.308,8,10,.800,15,21,36,19,5,6,10,14,78,False,2519,Illinois
10,School Totals,200,32,63,.508,24,51,.471,8,12,.667,7,9,.778,7,24,31,19,10,2,14,17,79,False,2520,Illinois
10,School Totals,200,24,54,.444,12,31,.387,12,23,.522,13,16,.813,7,17,24,14,4,6,6,17,73,False,2521,Illinois
12,School Totals,200,25,58,.431,17,40,.425,8,18,.444,16,23,.696,12,21,33,12,6,6,11,18,74,False,2522,Illinois
13,School Totals,200,30,62,.484,20,40,.500,10,22,.455,16,20,.800,12,17,29,20,7,4,15,13,86,False,2523,Illinois
10,School Totals,200,18,55,.327,14,38,.368,4,17,.235,14,19,.737,13,18,31,15,8,7,15,19,54,False,2524,Illinois
13,School Totals,200,27,70,0.386,22,52,0.423,5,18,0.278,5,12,0.417,18,26,44,16,2,6,12,21,64,False,2525,Illinois
10,School Totals,200,32,48,.667,19,30,.633,13,18,.722,10,13,.769,6,21,27,20,4,3,17,17,87,False,2526,Illinois
11,School Totals,200,23,41,.561,17,29,.586,6,12,.500,17,22,.773,5,26,31,14,2,3,12,15,69,False,2527,Illinois
14,School Totals,200,31,44,.705,22,30,.733,9,14,.643,17,25,.680,2,31,33,25,4,3,22,13,88,False,2528,Illinois
10,School Totals,200,19,46,.413,12,30,.400,7,16,.438,10,11,.909,4,23,27,12,4,6,15,13,55,False,1911,Illinois
11,School Totals,200,16,53,.302,12,37,.324,4,16,.250,30,36,.833,14,18,32,9,3,1,7,30,66,False,2529,Illinois
10,School Totals,200,25,47,.532,17,30,.567,8,17,.471,13,19,.684,7,21,28,17,4,1,9,12,71,False,1222,Illinois
9,School Totals,200,28,65,.431,24,48,.500,4,17,.235,8,10,.800,9,23,32,17,3,4,9,21,68,False,1586,Illinois
9,School Totals,200,19,59,.322,14,39,.359,5,20,.250,6,8,.750,13,21,34,11,6,7,12,14,49,False,51,Illinois
12,School Totals,200,24,52,.462,18,33,.545,6,19,.316,14,18,.778,9,25,34,21,2,6,7,18,68,False,1915,Illinois
9,School Totals,200,25,51,.490,17,37,.459,8,14,.571,12,16,.750,5,22,27,17,7,5,13,20,70,False,2530,Illinois
10,School Totals,200,22,56,.393,18,40,.450,4,16,.250,23,27,.852,7,26,33,14,11,4,12,16,71,False,2531,Illinois
10,School Totals,200,24,55,.436,19,39,.487,5,16,.313,17,22,.773,4,21,25,11,8,2,14,25,70,False,2532,Illinois
9,School Totals,200,23,52,.442,19,34,.559,4,18,.222,4,9,.444,7,28,35,17,1,2,12,12,54,False,838,Illinois
10,School Totals,200,22,59,.373,17,40,.425,5,19,.263,8,10,.800,9,16,25,13,9,6,9,19,57,False,1228,Illinois
12,School Totals,200,28,54,.519,17,33,.515,11,21,.524,3,3,1.000,9,19,28,18,1,8,16,14,70,False,1592,Illinois
10,School Totals,200,31,56,.554,25,38,.658,6,18,.333,13,18,.722,9,21,30,21,7,2,13,16,81,False,2533,Illinois
10,School Totals,200,27,54,.500,22,39,.564,5,15,.333,8,11,.727,5,26,31,18,1,3,13,20,67,False,2534,Illinois
14,School Totals,200,28,57,.491,22,40,.550,6,17,.353,10,13,.769,7,33,40,16,5,5,10,13,72,False,61,Illinois
9,School Totals,200,22,52,.423,13,26,.500,9,26,.346,2,3,.667,6,20,26,16,7,5,11,14,55,False,843,Illinois
13,School Totals,200,28,47,.596,21,34,.618,7,13,.538,10,14,.714,5,25,30,21,3,2,14,17,73,False,2535,Illinois
11,School Totals,200,23,60,.383,17,39,.436,6,21,.286,7,9,.778,9,21,30,16,7,2,12,18,59,False,2536,Illinois
13,School Totals,200,28,59,.475,22,38,.579,6,21,.286,5,9,.556,13,18,31,9,10,13,12,17,67,False,2537,Illinois
13,School Totals,200,21,51,.412,14,32,.438,7,19,.368,17,24,.708,13,32,45,15,7,11,22,10,66,False,2538,Illinois
14,School Totals,200,29,56,.518,25,42,.595,4,14,.286,17,22,.773,9,32,41,11,9,6,21,26,79,False,2539,Illinois
10,School Totals,200,22,52,.423,19,42,.452,3,10,.300,23,28,.821,9,21,30,9,5,5,8,19,70,False,2540,Illinois
10,School Totals,200,21,51,.412,15,32,.469,6,19,.316,15,17,.882,7,16,23,13,0,4,6,15,63,False,2541,Illinois
14,School Totals,200,35,62,0.565,27,41,0.659,8,21,0.381,12,18,0.667,8,22,30,25,7,2,11,15,90,False,2542,Illinois
13,School Totals,200,23,55,.418,16,32,.500,7,23,.304,18,20,.900,13,21,34,13,3,6,11,21,71,False,465,Illinois
14,School Totals,200,32,60,.533,27,44,.614,5,16,.313,13,17,.765,7,19,26,16,9,2,12,21,82,False,2543,Illinois
12,School Totals,200,15,47,.319,8,21,.381,7,26,.269,11,17,.647,8,16,24,9,9,2,13,12,48,False,2544,Illinois
13,School Totals,200,31,55,.564,21,33,.636,10,22,.455,8,12,.667,7,24,31,21,4,5,8,11,80,False,2545,Illinois
12,School Totals,200,16,63,.254,9,38,.237,7,25,.280,9,18,.500,11,22,33,12,7,1,14,19,48,False,2546,Illinois
13,School Totals,200,24,57,.421,17,36,.472,7,21,.333,9,13,.692,13,26,39,17,3,5,14,15,64,False,2547,Illinois
10,School Totals,200,31,62,.500,27,46,.587,4,16,.250,8,10,.800,11,23,34,10,5,2,17,16,74,False,2548,Illinois
10,School Totals,250,28,60,.467,21,39,.538,7,21,.333,18,22,.818,8,29,37,14,3,10,21,17,81,False,2549,Illinois
14,School Totals,200,24,56,.429,19,35,.543,5,21,.238,7,13,.538,12,16,28,10,7,0,17,21,60,False,2550,Illinois
9,School Totals,200,21,49,.429,17,39,.436,4,10,.400,11,20,.550,7,23,30,12,4,6,11,18,57,False,2551,Illinois
11,School Totals,200,23,44,.523,20,33,.606,3,11,.273,10,19,.526,2,17,19,8,5,2,13,20,59,False,2552,Illinois
9,School Totals,200,27,45,.600,16,27,.593,11,18,.611,14,17,.824,4,21,25,12,9,4,17,10,79,False,1616,Illinois
10,School Totals,200,17,49,.347,10,27,.370,7,22,.318,11,13,.846,10,20,30,14,5,3,14,15,52,False,1940,Illinois
9,School Totals,200,24,55,.436,21,43,.488,3,12,.250,12,15,.800,4,25,29,8,2,0,9,17,63,False,2553,Illinois
10,School Totals,225,25,62,.403,22,41,.537,3,21,.143,19,29,.655,14,22,36,12,7,7,16,28,72,False,2554,Illinois
10,School Totals,200,15,46,.326,12,29,.414,3,17,.176,9,17,.529,8,22,30,7,4,6,12,17,42,False,1255,Illinois
9,School Totals,200,26,48,.542,15,24,.625,11,24,.458,7,11,.636,6,16,22,18,2,2,12,15,70,False,2555,Illinois
12,School Totals,200,26,50,.520,19,29,.655,7,21,.333,12,15,.800,3,18,21,15,5,4,15,30,71,False,87,Illinois
9,School Totals,200,21,54,.389,13,31,.419,8,23,.348,11,17,.647,12,19,31,10,2,3,13,19,61,False,870,Illinois
10,School Totals,200,25,56,.446,22,35,.629,3,21,.143,9,11,.818,6,20,26,11,4,3,12,11,62,False,2556,Illinois
14,School Totals,200,21,53,.396,15,30,.500,6,23,.261,9,16,.563,5,21,26,15,5,3,14,18,57,False,2557,Illinois
12,School Totals,200,25,63,.397,22,45,.489,3,18,.167,14,17,.824,10,13,23,11,7,1,8,19,67,False,1622,Illinois
10,School Totals,200,22,52,.423,16,34,.471,6,18,.333,15,17,.882,11,20,31,12,4,4,17,14,65,False,2558,Illinois
13,School Totals,200,21,54,.389,17,40,.425,4,14,.286,15,21,.714,6,19,25,10,3,2,8,21,61,False,874,Illinois
14,School Totals,200,21,53,.396,17,36,.472,4,17,.235,10,14,.714,6,22,28,3,2,3,10,25,56,False,2559,Illinois
9,School Totals,200,27,62,.435,20,36,.556,7,26,.269,0,0,,10,22,32,18,4,5,12,13,61,False,2560,Illinois
14,School Totals,200,29,74,.392,16,44,.364,13,30,.433,4,10,.400,18,28,46,14,5,2,12,12,75,False,2561,Illinois
14,School Totals,200,32,65,.492,21,40,.525,11,25,.440,14,22,.636,13,20,33,17,9,7,8,14,89,False,2562,Illinois
13,School Totals,225,27,64,.422,16,33,.485,11,31,.355,13,20,.650,7,21,28,8,8,8,8,26,78,False,2563,Illinois
14,School Totals,200,33,62,.532,20,33,.606,13,29,.448,15,17,.882,13,26,39,17,11,1,20,19,94,False,2564,Illinois
14,School Totals,200,29,59,.492,18,31,.581,11,28,.393,15,18,.833,9,31,40,13,8,6,11,18,84,False,2565,Illinois
14,School Totals,200,24,50,.480,14,25,.560,10,25,.400,20,21,.952,5,24,29,11,5,5,8,19,78,False,2566,Illinois
10,School Totals,200,21,48,.438,14,29,.483,7,19,.368,14,18,.778,6,16,22,9,7,2,18,14,63,False,2567,Illinois
10,School Totals,200,27,57,.474,13,29,.448,14,28,.500,7,18,.389,10,23,33,15,7,7,14,17,75,False,2568,Illinois
11,School Totals,200,26,65,.400,19,41,.463,7,24,.292,13,19,.684,15,16,31,9,12,4,11,16,72,False,2569,Illinois
11,School Totals,200,30,60,.500,19,34,.559,11,26,.423,14,17,.824,8,16,24,9,9,2,9,22,85,False,2570,Illinois
11,School Totals,200,21,60,.350,15,37,.405,6,23,.261,16,27,.593,15,23,38,6,7,7,9,9,64,False,2571,Illinois
10,School Totals,200,25,50,.500,19,27,.704,6,23,.261,10,13,.769,10,29,39,16,5,9,20,15,66,False,2572,Illinois
10,School Totals,200,25,74,.338,17,42,.405,8,32,.250,15,19,.789,10,19,29,10,5,4,7,21,73,False,2573,Illinois
11,School Totals,200,25,52,.481,21,37,.568,4,15,.267,27,40,.675,9,21,30,14,11,5,11,15,81,False,2574,Illinois
10,School Totals,200,21,59,.356,11,33,.333,10,26,.385,9,14,.643,10,21,31,10,6,6,9,20,61,False,2575,Illinois
9,School Totals,200,28,58,.483,20,31,.645,8,27,.296,10,12,.833,9,30,39,12,8,8,18,15,74,False,1644,Illinois
12,School Totals,200,23,65,.354,20,41,.488,3,24,.125,18,21,.857,13,16,29,8,7,4,7,21,67,False,2576,Illinois
14,School Totals,200,18,51,.353,16,37,.432,2,14,.143,13,20,.650,8,15,23,2,8,2,9,19,51,False,2577,Illinois
10,School Totals,200,19,49,.388,16,29,.552,3,20,.150,13,20,.650,13,16,29,6,9,4,18,26,54,False,2578,Illinois
14,School Totals,200,24,53,.453,17,31,.548,7,22,.318,16,21,.762,13,25,38,12,10,3,14,24,71,False,2579,Illinois
9,School Totals,200,23,62,.371,17,36,.472,6,26,.231,8,9,.889,14,20,34,7,7,1,15,14,60,False,898,Illinois
10,School Totals,200,27,60,.450,18,35,.514,9,25,.360,12,15,.800,9,13,22,12,9,2,8,26,75,False,1289,Illinois
10,School Totals,200,28,64,.438,26,51,.510,2,13,.154,10,15,.667,7,19,26,10,4,2,9,27,68,False,2580,Illinois
9,School Totals,200,26,58,.448,17,34,.500,9,24,.375,13,15,.867,8,13,21,10,7,3,9,16,74,False,121,Illinois
10,School Totals,200,18,49,.367,7,26,.269,11,23,.478,10,14,.714,7,16,23,11,4,3,7,15,57,False,2581,Illinois
14,School Totals,200,29,68,.426,22,43,.512,7,25,.280,14,16,.875,17,23,40,14,5,1,11,16,79,False,2582,Illinois
14,School Totals,200,24,55,.436,18,35,.514,6,20,.300,8,15,.533,10,25,35,13,4,4,9,21,62,False,2583,Illinois
9,School Totals,200,17,43,.395,10,19,.526,7,24,.292,23,36,.639,3,15,18,8,5,1,10,21,64,False,1968,Illinois
9,School Totals,200,21,51,.412,14,29,.483,7,22,.318,9,14,.643,7,17,24,7,3,4,13,16,58,False,904,Illinois
10,School Totals,200,24,55,.436,15,29,.517,9,26,.346,15,18,.833,8,24,32,10,4,2,9,12,72,False,2584,Illinois
9,School Totals,200,18,63,.286,9,34,.265,9,29,.310,10,17,.588,13,24,37,8,9,4,11,19,55,False,2585,Illinois
8,School Totals,200,19,54,0.352,12,29,0.414,7,25,0.28,10,13,0.769,9,16,25,6,8,2,12,19,55,False,1654,Illinois
9,School Totals,200,18,56,.321,12,31,.387,6,25,.240,9,10,.900,12,12,24,8,6,5,5,15,51,False,2586,Illinois
10,School Totals,200,20,58,.345,15,41,.366,5,17,.294,19,21,.905,9,11,20,6,3,5,12,20,64,False,130,Illinois
9,School Totals,200,16,52,.308,8,21,.381,8,31,.258,17,24,.708,8,23,31,10,8,4,12,12,57,False,2587,Illinois
9,School Totals,200,23,61,.377,16,34,.471,7,27,.259,6,7,.857,15,21,36,7,2,3,8,17,59,False,2588,Illinois
12,School Totals,200,27,61,.443,23,41,.561,4,20,.200,22,30,.733,16,31,47,14,4,2,15,17,80,False,2589,Illinois
12,School Totals,200,32,61,.525,28,49,.571,4,12,.333,18,28,.643,14,21,35,14,2,11,5,19,86,False,2590,Illinois
12,School Totals,200,21,66,.318,16,48,.333,5,18,.278,17,23,.739,14,28,42,9,3,8,8,17,64,False,2591,Illinois
12,School Totals,200,28,59,.475,18,34,.529,10,25,.400,15,21,.714,18,30,48,19,4,5,12,16,81,False,2592,Illinois
12,School Totals,200,26,54,.481,17,33,.515,9,21,.429,16,22,.727,13,22,35,11,6,4,10,13,77,False,2593,Illinois
11,School Totals,200,24,67,.358,18,49,.367,6,18,.333,7,9,.778,11,24,35,11,7,3,11,14,61,False,2594,Illinois
11,School Totals,200,20,51,.392,16,30,.533,4,21,.190,13,23,.565,9,22,31,6,7,4,12,16,57,False,2595,Illinois
11,School Totals,200,23,55,.418,16,32,.500,7,23,.304,11,15,.733,7,18,25,13,3,7,9,19,64,False,2596,Illinois
12,School Totals,199,32,52,.615,20,29,.690,12,23,.522,5,5,1.000,5,22,27,19,6,1,14,19,81,False,2597,Illinois
11,School Totals,200,26,50,.520,19,32,.594,7,18,.389,13,17,.765,4,22,26,10,2,5,8,16,72,False,2598,Illinois
11,School Totals,200,24,56,.429,19,39,.487,5,17,.294,11,13,.846,8,17,25,8,10,2,12,16,64,False,2599,Illinois
10,School Totals,200,23,57,.404,15,35,.429,8,22,.364,11,18,.611,9,20,29,7,7,2,11,16,65,False,2600,Illinois
12,School Totals,200,25,56,.446,20,37,.541,5,19,.263,19,25,.760,7,20,27,9,6,6,4,14,74,False,2601,Illinois
11,School Totals,225,31,69,.449,29,52,.558,2,17,.118,19,26,.731,10,18,28,7,12,5,10,21,83,False,148,Illinois
12,School Totals,200,20,56,.357,13,33,.394,7,23,.304,28,35,.800,10,31,41,10,8,3,8,20,75,False,1985,Illinois
12,School Totals,200,25,79,.316,20,60,.333,5,19,.263,15,19,.789,23,23,46,4,3,0,8,23,70,False,2602,Illinois
10,School Totals,200,18,64,.281,14,45,.311,4,19,.211,3,6,.500,12,25,37,11,8,4,5,16,43,False,2603,Illinois
10,School Totals,200,20,52,.385,13,31,.419,7,21,.333,11,18,.611,8,19,27,7,6,3,12,14,58,False,2604,Illinois
10,School Totals,200,23,61,.377,16,38,.421,7,23,.304,9,10,.900,7,15,22,8,5,1,9,21,62,False,1317,Illinois
10,School Totals,200,21,51,.412,16,33,.485,5,18,.278,8,12,.667,8,18,26,10,5,4,15,16,55,False,1678,Illinois
10,School Totals,200,18,54,.333,13,31,.419,5,23,.217,5,6,.833,4,22,26,5,6,5,13,19,46,False,154,Illinois
11,School Totals,200,25,56,.446,19,41,.463,6,15,.400,18,23,.783,7,19,26,12,6,6,12,24,74,False,2605,Illinois
10,School Totals,200,21,52,.404,17,42,.405,4,10,.400,17,21,.810,7,16,23,7,5,3,9,23,63,False,2606,Illinois
11,School Totals,200,19,49,.388,12,27,.444,7,22,.318,15,23,.652,7,25,32,10,5,4,6,15,60,False,1990,Illinois
11,School Totals,200,18,49,.367,14,32,.438,4,17,.235,18,26,.692,14,21,35,9,6,1,13,20,58,False,2607,Illinois
10,School Totals,200,15,53,.283,10,37,.270,5,16,.313,4,4,1.000,8,26,34,8,3,5,13,15,39,False,1683,Illinois
11,School Totals,200,19,45,.422,11,32,.344,8,13,.615,16,20,.800,8,19,27,13,9,4,11,16,62,False,2608,Illinois
11,School Totals,200,19,51,.373,10,27,.370,9,24,.375,13,19,.684,11,23,34,12,11,0,9,11,60,False,2609,Illinois
11,School Totals,200,21,44,.477,13,26,.500,8,18,.444,3,7,.429,5,21,26,12,14,4,14,16,53,False,1325,Illinois
11,School Totals,200,20,52,.385,18,34,.529,2,18,.111,11,16,.688,5,17,22,7,4,0,8,14,53,False,943,Illinois
9,School Totals,200,25,54,.463,18,35,.514,7,19,.368,9,12,.750,8,22,30,12,8,3,11,16,66,False,2610,Illinois
11,School Totals,200,20,50,.400,14,35,.400,6,15,.400,18,22,.818,7,21,28,10,8,6,9,16,64,False,166,Illinois
10,School Totals,200,24,53,.453,19,36,.528,5,17,.294,10,12,.833,7,21,28,10,4,2,8,14,63,False,944,Illinois
10,School Totals,200,23,46,.500,15,29,.517,8,17,.471,12,15,.800,6,26,32,10,3,2,11,13,66,False,2611,Illinois
11,School Totals,200,21,56,.375,18,35,.514,3,21,.143,4,5,.800,2,18,20,7,9,2,5,12,49,False,2612,Illinois
11,School Totals,200,23,56,.411,16,37,.432,7,19,.368,27,34,.794,8,23,31,11,5,5,9,20,80,False,2613,Illinois
13,School Totals,200,41,74,.554,26,46,.565,15,28,.536,17,19,.895,12,35,47,24,10,5,9,16,114,False,2614,Illinois
13,School Totals,200,40,67,.597,26,42,.619,14,25,.560,13,18,.722,9,24,33,20,9,3,10,16,107,False,2615,Illinois
13,School Totals,200,30,62,.484,22,41,.537,8,21,.381,21,28,.750,14,21,35,17,7,6,7,21,89,False,2616,Illinois
13,School Totals,200,28,66,.424,19,46,.413,9,20,.450,23,28,.821,10,33,43,11,15,3,13,23,88,False,2617,Illinois
11,School Totals,200,23,59,.390,17,36,.472,6,23,.261,10,18,.556,8,22,30,15,6,2,5,20,62,False,2618,Illinois
10,School Totals,200,23,69,.333,16,39,.410,7,30,.233,8,12,.667,14,25,39,7,1,1,7,20,61,False,2619,Illinois
13,School Totals,200,23,48,.479,18,36,.500,5,12,.417,19,21,.905,7,20,27,10,8,3,14,18,70,False,2620,Illinois
12,School Totals,200,25,61,.410,20,45,.444,5,16,.313,4,8,.500,12,15,27,13,6,3,14,19,59,False,2621,Illinois
11,School Totals,200,23,64,.359,16,45,.356,7,19,.368,17,20,.850,11,23,34,17,5,5,9,18,70,False,2622,Illinois
13,School Totals,200,21,49,.429,12,28,.429,9,21,.429,22,26,.846,4,30,34,12,3,8,16,16,73,False,2623,Illinois
10,School Totals,200,24,57,.421,20,39,.513,4,18,.222,10,14,.714,9,21,30,7,3,1,8,13,62,False,2624,Illinois
13,School Totals,200,36,65,.554,29,44,.659,7,21,.333,14,18,.778,7,35,42,19,4,2,6,13,93,False,2625,Illinois
10,School Totals,225,24,58,.414,18,43,.419,6,15,.400,11,14,.786,7,28,35,11,2,4,12,15,65,False,963,Illinois
10,School Totals,200,20,45,.444,11,21,.524,9,24,.375,12,16,.750,3,17,20,14,8,2,18,18,61,False,1704,Illinois
9,School Totals,200,20,55,.364,13,32,.406,7,23,.304,17,20,.850,7,28,35,7,4,4,7,19,64,False,577,Illinois
9,School Totals,200,15,55,.273,9,26,.346,6,29,.207,7,8,.875,5,22,27,7,7,4,9,13,43,False,2626,Illinois
9,School Totals,200,26,62,.419,18,38,.474,8,24,.333,12,14,.857,8,18,26,12,6,3,3,14,72,False,2627,Illinois
9,School Totals,200,26,55,.473,14,28,.500,12,27,.444,10,12,.833,4,21,25,18,4,3,10,18,74,False,184,Illinois
10,School Totals,200,21,60,.350,18,50,.360,3,10,.300,21,24,.875,12,25,37,13,8,5,9,12,66,False,2628,Illinois
9,School Totals,200,23,61,.377,12,37,.324,11,24,.458,14,16,.875,12,15,27,12,8,4,10,21,71,False,2629,Illinois
9,School Totals,200,20,53,.377,12,38,.316,8,15,.533,12,17,.706,9,13,22,13,12,2,10,17,60,False,2017,Illinois
9,School Totals,200,25,52,.481,18,33,.545,7,19,.368,9,9,1.000,6,21,27,16,5,1,10,16,66,False,2350,Illinois
9,School Totals,200,21,51,.412,16,34,.471,5,17,.294,12,16,.750,5,25,30,8,6,3,8,20,59,False,1352,Illinois
13,School Totals,225,24,62,.387,17,40,.425,7,22,.318,9,13,.692,11,27,38,13,10,5,7,12,64,False,974,Illinois
13,School Totals,200,18,45,.400,14,34,.412,4,11,.364,9,11,.818,9,12,21,4,3,1,10,16,49,False,2630,Illinois
10,School Totals,200,15,52,.288,13,36,.361,2,16,.125,21,28,.750,8,17,25,5,5,2,5,22,53,False,1355,Illinois
10,School Totals,200,19,57,.333,12,36,.333,7,21,.333,15,16,.938,10,23,33,8,9,1,12,25,60,False,2631,Illinois
12,School Totals,200,27,57,.474,13,28,.464,14,29,.483,18,22,.818,14,26,40,15,5,1,10,17,86,False,2632,Illinois
13,School Totals,200,21,49,.429,14,33,.424,7,16,.438,20,23,.870,9,21,30,9,4,4,8,13,69,False,2633,Illinois
10,School Totals,200,18,53,.340,14,34,.412,4,19,.211,18,26,.692,10,18,28,6,10,2,14,21,58,False,2634,Illinois
12,School Totals,200,22,59,.373,21,46,.457,1,13,.077,10,13,.769,11,23,34,5,4,5,10,14,55,False,979,Illinois
10,School Totals,200,21,65,.323,14,42,.333,7,23,.304,9,11,.818,13,18,31,10,6,2,10,21,58,False,2635,Illinois
11,School Totals,200,32,71,.451,27,55,.491,5,16,.313,12,23,.522,9,28,37,14,2,2,5,14,81,False,2636,Illinois
11,School Totals,200,28,57,.491,21,40,.525,7,17,.412,17,27,.630,7,25,32,15,7,4,11,17,80,False,2637,Illinois
10,School Totals,200,23,60,.383,14,35,.400,9,25,.360,4,6,.667,13,21,34,17,5,3,13,21,59,False,2638,Illinois
11,School Totals,200,30,58,.517,26,45,.578,4,13,.308,13,18,.722,7,19,26,14,6,3,15,17,77,False,2639,Illinois
10,School Totals,200,22,55,.400,13,29,.448,9,26,.346,29,41,.707,11,22,33,14,8,1,14,19,82,False,2640,Illinois
11,School Totals,200,27,56,.482,22,44,.500,5,12,.417,13,19,.684,7,21,28,14,10,0,11,17,72,False,2641,Illinois
12,School Totals,200,29,63,.460,19,37,.514,10,26,.385,5,8,.625,7,22,29,12,2,0,10,13,73,False,2642,Illinois
11,School Totals,200,30,71,.423,19,42,.452,11,29,.379,8,9,.889,8,22,30,15,7,1,3,20,79,False,2643,Illinois
12,School Totals,200,28,53,.528,21,35,.600,7,18,.389,17,21,.810,8,20,28,14,7,1,15,18,80,False,2644,Illinois
11,School Totals,200,26,65,.400,18,39,.462,8,26,.308,9,11,.818,5,15,20,12,7,1,5,18,69,False,2645,Illinois
11,School Totals,200,25,53,.472,16,31,.516,9,22,.409,24,35,.686,5,20,25,18,5,5,11,15,83,False,2646,Illinois
11,School Totals,200,30,62,.484,16,32,.500,14,30,.467,17,20,.850,6,27,33,23,4,4,8,16,91,False,2647,Illinois
10,School Totals,200,23,57,.404,14,28,.500,9,29,.310,13,19,.684,4,23,27,9,6,3,7,16,68,False,2648,Illinois
10,School Totals,200,24,56,.429,15,31,.484,9,25,.360,11,13,.846,4,20,24,14,6,3,13,18,68,False,994,Illinois
10,School Totals,200,26,65,.400,14,33,.424,12,32,.375,9,11,.818,7,22,29,13,2,0,7,23,73,False,1732,Illinois
11,School Totals,200,17,57,.298,15,42,.357,2,15,.133,18,21,.857,4,21,25,7,6,2,6,14,54,False,1381,Illinois
10,School Totals,200,26,48,.542,17,31,.548,9,17,.529,23,28,.821,1,21,22,14,5,3,10,19,84,False,2649,Illinois
11,School Totals,200,23,59,.390,12,22,.545,11,37,.297,10,15,.667,3,17,20,16,3,0,5,19,67,False,2650,Illinois
13,School Totals,200,22,51,.431,15,33,.455,7,18,.389,18,25,.720,7,16,23,13,5,0,15,19,69,False,219,Illinois
9,School Totals,225,27,62,.435,21,44,.477,6,18,.333,16,22,.727,7,37,44,17,4,1,14,15,76,False,2651,Illinois
11,School Totals,225,18,56,.321,9,27,.333,9,29,.310,18,31,.581,4,28,32,8,4,0,10,15,63,False,1737,Illinois
11,School Totals,200,18,50,.360,12,36,.333,6,14,.429,13,15,.867,4,18,22,6,6,0,10,17,55,False,2652,Illinois
10,School Totals,275,35,77,.455,25,48,.521,10,29,.345,30,34,.882,4,33,37,17,4,1,11,23,110,False,2372,Illinois
11,School Totals,200,26,66,.394,18,41,.439,8,25,.320,5,6,.833,6,25,31,12,6,1,10,14,65,False,2653,Illinois
11,School Totals,200,21,57,.368,11,32,.344,10,25,.400,4,8,.500,13,24,37,14,4,0,11,17,56,False,2654,Illinois
12,School Totals,200,27,59,.458,18,37,.486,9,22,.409,19,23,.826,9,24,33,17,8,5,9,18,82,False,2374,Illinois
10,School Totals,200,22,56,.393,13,34,.382,9,22,.409,7,10,.700,8,22,30,10,5,2,12,26,60,False,2655,Illinois
11,School Totals,200,19,48,.396,13,26,.500,6,22,.273,3,4,.750,1,12,13,6,3,1,11,14,47,False,229,Illinois
11,School Totals,200,28,49,.571,18,27,.667,10,22,.455,18,22,.818,2,19,21,18,13,6,11,16,84,False,2656,Illinois
11,School Totals,200,22,57,.386,17,37,.459,5,20,.250,6,7,.857,6,18,24,13,6,3,8,13,55,False,623,Illinois
10,School Totals,250,27,67,.403,23,51,.451,4,16,.250,21,24,.875,8,28,36,6,9,2,14,23,79,False,2049,Illinois
12,School Totals,200,32,58,.552,18,32,.563,14,26,.538,7,9,.778,3,30,33,19,11,0,8,13,85,False,2657,Illinois
10,School Totals,200,26,58,.448,16,35,.457,10,23,.435,6,6,1.000,8,21,29,20,9,5,12,19,68,False,2658,Illinois
12,School Totals,200,22,56,.393,18,38,.474,4,18,.222,10,16,.625,5,16,21,11,4,2,7,9,58,False,2659,Illinois
13,School Totals,200,30,53,.566,19,22,.864,11,31,.355,10,12,.833,5,29,34,14,3,5,15,14,81,False,2660,Illinois
11,School Totals,200,26,59,.441,19,40,.475,7,19,.368,20,30,.667,10,21,31,10,5,4,8,23,79,False,2661,Illinois
14,School Totals,200,44,79,.557,28,51,.549,16,28,.571,8,13,.615,10,33,43,28,7,7,6,15,112,False,2662,Illinois
14,School Totals,200,27,52,.519,19,33,.576,8,19,.421,27,38,.711,5,31,36,10,6,1,15,21,89,False,2663,Illinois
11,School Totals,225,30,68,.441,19,44,.432,11,24,.458,9,16,.563,7,22,29,15,5,2,22,21,80,False,2664,Illinois
12,School Totals,200,22,56,.393,18,39,.462,4,17,.235,9,17,.529,14,24,38,10,2,1,20,24,57,False,2665,Illinois
11,School Totals,200,19,58,.328,14,36,.389,5,22,.227,18,21,.857,14,22,36,11,2,0,10,19,61,False,2666,Illinois
12,School Totals,200,30,60,.500,23,42,.548,7,18,.389,21,26,.808,10,19,29,12,9,3,10,16,88,False,2667,Illinois
11,School Totals,200,22,52,.423,16,38,.421,6,14,.429,14,21,.667,8,23,31,14,6,2,11,19,64,False,2668,Illinois
12,School Totals,200,27,49,.551,20,33,.606,7,16,.438,24,30,.800,4,21,25,14,7,2,15,15,85,False,2669,Illinois
13,School Totals,200,34,64,.531,25,43,.581,9,21,.429,15,20,.750,12,36,48,15,4,4,14,14,92,False,2670,Illinois
11,School Totals,200,30,64,.469,20,38,.526,10,26,.385,5,11,.455,8,29,37,18,7,3,12,19,75,False,2671,Illinois
11,School Totals,200,24,49,.490,17,32,.531,7,17,.412,20,30,.667,6,30,36,11,3,3,15,21,75,False,2672,Illinois
13,School Totals,200,21,59,.356,17,37,.459,4,22,.182,13,19,.684,11,21,32,9,5,0,17,18,59,False,642,Illinois
11,School Totals,200,26,60,.433,20,41,.488,6,19,.316,17,23,.739,11,30,41,7,3,4,9,14,75,False,1759,Illinois
13,School Totals,200,24,54,.444,18,37,.486,6,17,.353,26,33,.788,8,17,25,11,5,2,9,21,80,False,251,Illinois
13,School Totals,200,34,53,.642,25,39,.641,9,14,.643,8,10,.800,7,22,29,21,3,1,9,14,85,False,1028,Illinois
11,School Totals,200,21,56,.375,14,34,.412,7,22,.318,7,10,.700,5,27,32,12,3,1,12,20,56,False,645,Illinois
14,School Totals,200,27,67,.403,24,50,.480,3,17,.176,11,22,.500,10,18,28,13,5,3,3,21,68,False,2673,Illinois
13,School Totals,200,22,48,.458,20,36,.556,2,12,.167,11,14,.786,6,21,27,9,4,2,16,20,57,False,1031,Illinois
11,School Totals,200,26,58,.448,17,39,.436,9,19,.474,15,19,.789,11,25,36,18,8,2,9,19,76,False,2674,Illinois
11,School Totals,200,27,65,.415,19,43,.442,8,22,.364,5,8,.625,14,23,37,15,7,2,13,16,67,False,2068,Illinois
11,School Totals,200,16,58,.276,11,37,.297,5,21,.238,6,9,.667,11,19,30,7,5,3,10,15,43,False,2675,Illinois
12,School Totals,200,24,63,.381,20,41,.488,4,22,.182,7,11,.636,8,28,36,14,2,0,9,21,59,False,2676,Illinois
11,School Totals,200,24,53,.453,16,34,.471,8,19,.421,12,18,.667,4,25,29,18,9,4,12,17,68,False,2677,Illinois
9,School Totals,200,24,50,.480,16,33,.485,8,17,.471,14,22,.636,6,14,20,12,7,0,14,21,70,False,2070,Illinois
10,School Totals,200,27,57,.474,18,32,.563,9,25,.360,7,14,.500,7,26,33,15,6,3,14,22,70,False,2678,Illinois
13,School Totals,200,22,55,.400,16,37,.432,6,18,.333,16,25,.640,11,31,42,10,6,4,7,19,66,False,2679,Illinois
9,School Totals,200,25,52,.481,12,26,.462,13,26,.500,10,16,.625,4,24,28,17,12,1,13,16,73,False,2680,Illinois
9,School Totals,200,27,60,.450,16,34,.471,11,26,.423,8,13,.615,7,17,24,14,6,1,7,16,73,False,1423,Illinois
9,School Totals,200,21,59,.356,13,34,.382,8,25,.320,9,13,.692,9,23,32,13,6,2,7,17,59,False,2401,Illinois
10,School Totals,200,22,48,.458,16,33,.485,6,15,.400,5,9,.556,4,22,26,8,2,2,14,13,55,False,1041,Illinois
15,School Totals,200,30,62,.484,21,41,.512,9,21,.429,13,19,.684,12,27,39,18,7,5,13,19,82,False,2681,Illinois
14,School Totals,200,24,57,.421,15,35,.429,9,22,.409,14,19,.737,9,25,34,17,10,4,9,19,71,False,2682,Illinois
8,School Totals,200,19,62,.306,7,24,.292,12,38,.316,8,12,.667,5,17,22,12,10,0,9,22,58,False,2683,Illinois
15,School Totals,200,32,63,.508,28,42,.667,4,21,.190,34,37,.919,12,26,38,17,8,4,10,26,102,False,2684,Illinois
11,School Totals,200,26,58,.448,20,37,.541,6,21,.286,19,27,.704,9,24,33,17,5,3,18,21,77,False,2685,Illinois
11,School Totals,200,25,60,.417,20,37,.541,5,23,.217,27,36,.750,18,19,37,14,6,4,18,27,82,False,2686,Illinois
15,School Totals,200,34,77,.442,27,62,.435,7,15,.467,16,26,.615,14,27,41,19,8,0,5,22,91,False,2687,Illinois
15,School Totals,200,32,68,.471,22,44,.500,10,24,.417,22,31,.710,13,20,33,19,13,2,12,22,96,False,2688,Illinois
12,School Totals,200,28,62,.452,16,33,.485,12,29,.414,18,24,.750,8,19,27,20,2,3,8,25,86,False,2689,Illinois
11,School Totals,200,24,62,.387,12,33,.364,12,29,.414,13,14,.929,13,22,35,15,7,1,19,24,73,False,2690,Illinois
10,School Totals,225,22,53,.415,19,35,.543,3,18,.167,21,26,.808,6,30,36,8,8,0,18,23,68,False,2691,Illinois
11,School Totals,225,36,70,.514,28,45,.622,8,25,.320,11,15,.733,7,17,24,13,16,1,15,19,91,False,670,Illinois
11,School Totals,200,21,53,.396,19,40,.475,2,13,.154,20,28,.714,12,23,35,9,9,5,25,19,64,False,2692,Illinois
11,School Totals,200,30,67,.448,19,42,.452,11,25,.440,11,15,.733,14,19,33,13,6,0,15,36,82,False,2693,Illinois
13,School Totals,200,34,73,.466,23,39,.590,11,34,.324,13,22,.591,25,25,50,20,12,0,8,13,92,False,2694,Illinois
11,School Totals,200,27,62,.435,21,48,.438,6,14,.429,9,13,.692,10,26,36,13,4,2,13,14,69,False,2695,Illinois
10,School Totals,200,23,59,.390,17,45,.378,6,14,.429,18,27,.667,9,17,26,8,11,3,9,20,70,False,2696,Illinois
11,School Totals,200,25,57,.439,20,38,.526,5,19,.263,7,11,.636,11,29,40,9,6,4,20,18,62,False,2697,Illinois
12,School Totals,200,25,72,.347,18,44,.409,7,28,.250,10,14,.714,16,18,34,16,8,1,10,24,67,False,2698,Illinois
11,School Totals,200,27,56,.482,24,42,.571,3,14,.214,12,14,.857,9,21,30,13,7,4,17,22,69,False,1063,Illinois
10,School Totals,225,36,74,.486,22,44,.500,14,30,.467,11,14,.786,12,13,25,22,5,3,13,31,97,False,2699,Illinois
10,School Totals,200,23,59,.390,20,41,.488,3,18,.167,14,20,.700,16,28,44,10,5,0,14,18,63,False,2700,Illinois
14,School Totals,200,23,57,.404,22,43,.512,1,14,.071,3,7,.429,14,15,29,7,5,4,12,22,50,False,2701,Illinois
13,School Totals,200,28,65,.431,20,37,.541,8,28,.286,10,14,.714,7,5,12,12,8,2,10,26,74,False,1445,Illinois
11,School Totals,200,23,50,.460,19,35,.543,4,15,.267,23,32,.719,4,18,22,10,4,2,13,22,73,False,290,Illinois
15,School Totals,200,33,58,.569,22,31,.710,11,27,.407,14,19,.737,8,18,26,16,9,5,17,22,91,False,2421,Illinois
11,School Totals,200,23,57,.404,14,29,.483,9,28,.321,12,17,.706,4,16,20,11,8,0,10,23,67,False,1792,Illinois
11,School Totals,200,21,55,.382,12,31,.387,9,24,.375,18,24,.750,10,16,26,7,8,1,11,24,69,False,2702,Illinois
12,School Totals,200,20,51,.392,15,32,.469,5,19,.263,7,12,.583,12,18,30,10,5,0,16,16,52,False,2097,Illinois
10,School Totals,200,22,54,.407,18,35,.514,4,19,.211,20,30,.667,7,15,22,12,10,3,12,24,68,False,296,Illinois
11,School Totals,200,27,62,.435,18,41,.439,9,21,.429,9,11,.818,9,24,33,16,3,2,8,19,72,False,2703,Illinois
14,School Totals,200,17,52,.327,11,36,.306,6,16,.375,21,28,.750,6,19,25,13,6,3,4,22,61,False,1452,Illinois
12,School Totals,200,33,66,.500,21,38,.553,12,28,.429,8,10,.800,7,13,20,19,8,1,6,21,86,False,2704,Illinois
13,School Totals,200,24,51,.471,15,29,.517,9,22,.409,18,23,.783,11,19,30,11,12,2,10,26,75,False,2425,Illinois
12,School Totals,200,32,66,.485,18,36,.500,14,30,.467,9,12,.750,6,11,17,23,8,4,8,29,87,False,2705,Illinois
13,School Totals,200,40,71,.563,28,43,.651,12,28,.429,7,14,.500,10,28,38,22,11,4,14,21,99,False,2706,Illinois
11,School Totals,200,31,67,.463,25,48,.521,6,19,.316,12,17,.706,8,16,24,17,13,3,14,24,80,False,2707,Illinois
11,School Totals,200,27,70,.386,17,39,.436,10,31,.323,14,19,.737,11,20,31,10,9,1,12,27,78,False,2708,Illinois
14,School Totals,200,23,60,.383,11,27,.407,12,33,.364,10,14,.714,8,16,24,13,4,2,9,22,68,False,2709,Illinois
11,School Totals,200,26,57,.456,15,34,.441,11,23,.478,11,17,.647,7,17,24,17,8,0,16,20,74,False,2710,Illinois
16,School Totals,200,33,64,.516,17,34,.500,16,30,.533,4,8,.500,11,26,37,26,3,3,13,20,86,False,2711,Illinois
12,School Totals,200,26,64,.406,17,40,.425,9,24,.375,13,15,.867,14,23,37,17,8,2,13,26,74,False,2712,Illinois
12,School Totals,200,23,57,.404,17,42,.405,6,15,.400,8,13,.615,11,17,28,10,5,1,14,23,60,False,2713,Illinois
11,School Totals,200,19,58,.328,13,39,.333,6,19,.316,23,27,.852,8,22,30,10,12,2,13,26,67,False,1808,Illinois
11,School Totals,200,28,59,.475,22,37,.595,6,22,.273,15,22,.682,8,23,31,12,6,6,16,22,77,False,2714,Illinois
10,School Totals,200,26,60,.433,16,35,.457,10,25,.400,11,21,.524,13,24,37,14,8,3,14,17,73,False,2715,Illinois
12,School Totals,200,24,59,.407,16,30,.533,8,29,.276,7,14,.500,8,19,27,6,4,1,14,17,63,False,2716,Illinois
10,School Totals,225,24,76,.316,15,38,.395,9,38,.237,14,19,.737,10,25,35,14,9,4,10,22,71,False,2717,Illinois
10,School Totals,200,25,58,.431,17,30,.567,8,28,.286,7,12,.583,10,19,29,15,8,0,16,25,65,False,314,Illinois
13,School Totals,200,22,56,.393,22,45,.489,0,11,.000,22,27,.815,8,21,29,10,9,5,11,19,66,False,2718,Illinois
11,School Totals,200,29,61,.475,22,43,.512,7,18,.389,4,7,.571,3,21,24,15,6,4,14,18,69,False,1100,Illinois
15,School Totals,200,37,66,.561,29,50,.580,8,16,.500,13,15,.867,9,26,35,11,8,0,16,20,95,False,2719,Illinois
14,School Totals,200,27,69,.391,16,37,.432,11,32,.344,6,9,.667,15,10,25,15,9,3,11,18,71,False,2720,Illinois
13,School Totals,200,22,62,.355,18,41,.439,4,21,.190,12,22,.545,14,15,29,9,10,0,10,19,60,False,2721,Illinois
11,School Totals,200,25,59,.424,17,36,.472,8,23,.348,20,22,.909,6,18,24,17,13,1,9,21,78,False,711,Illinois
13,School Totals,200,26,58,.448,19,34,.559,7,24,.292,16,22,.727,9,20,29,12,4,2,9,23,75,False,2722,Illinois
11,School Totals,200,27,56,.482,19,36,.528,8,20,.400,9,23,.391,6,25,31,12,4,3,10,23,71,False,2723,Illinois
11,School Totals,200,26,58,.448,17,34,.500,9,24,.375,18,22,.818,9,13,22,12,12,3,13,21,79,False,1477,Illinois
12,School Totals,225,36,73,.493,28,50,.560,8,23,.348,19,26,.731,8,26,34,16,8,4,10,21,99,False,2443,Illinois
12,School Totals,200,24,54,.444,18,33,.545,6,21,.286,9,17,.529,8,23,31,10,8,6,13,23,63,False,1819,Illinois
11,School Totals,200,21,56,.375,15,37,.405,6,19,.316,10,11,.909,7,23,30,9,6,4,13,21,58,False,2724,Illinois
11,School Totals,200,26,66,.394,20,46,.435,6,20,.300,18,28,.643,9,17,26,9,6,2,9,24,76,False,2127,Illinois
11,School Totals,200,20,61,.328,12,32,.375,8,29,.276,8,9,.889,12,13,25,10,5,4,10,23,56,False,2725,Illinois
11,School Totals,200,21,47,.447,15,31,.484,6,16,.375,33,38,.868,4,35,39,16,7,2,10,22,81,False,2726,Illinois
15,School Totals,200,26,52,.500,16,31,.516,10,21,.476,12,22,.545,5,19,24,15,2,4,10,17,74,False,330,Illinois
14,School Totals,200,18,53,.340,13,43,.302,5,10,.500,15,18,.833,10,21,31,11,9,1,17,21,56,False,2130,Illinois
12,School Totals,225,28,64,.438,23,49,.469,5,15,.333,13,17,.765,6,36,42,16,5,2,9,16,74,False,2727,Illinois
16,School Totals,200,26,50,.520,18,26,.692,8,24,.333,2,4,.500,6,18,24,18,6,4,13,18,62,False,2728,Illinois
10,School Totals,225,27,61,.443,22,42,.524,5,19,.263,19,29,.655,17,33,50,12,6,2,22,17,78,False,2729,Illinois
12,School Totals,200,29,64,.453,25,51,.490,4,13,.308,21,30,.700,16,30,46,13,5,0,17,21,83,False,2730,Illinois
12,School Totals,200,25,53,.472,20,37,.541,5,16,.313,14,20,.700,6,19,25,10,4,2,22,22,69,False,2731,Illinois
10,School Totals,200,23,54,.426,18,42,.429,5,12,.417,15,23,.652,10,33,43,14,3,3,15,8,66,False,2732,Illinois
14,School Totals,200,33,68,.485,30,50,.600,3,18,.167,16,21,.762,21,32,53,17,4,4,13,13,85,False,2733,Illinois
14,School Totals,200,45,70,.643,37,52,.712,8,18,.444,22,27,.815,13,28,41,29,9,1,9,14,120,False,2734,Illinois
13,School Totals,200,39,63,.619,28,38,.737,11,25,.440,28,37,.757,10,29,39,25,13,4,14,13,117,False,2735,Illinois
10,School Totals,200,28,53,.528,22,36,.611,6,17,.353,17,23,.739,8,22,30,16,4,4,13,17,79,False,2736,Illinois
11,School Totals,200,22,56,.393,19,42,.452,3,14,.214,11,16,.688,8,28,36,10,5,1,13,17,58,False,734,Illinois
9,School Totals,200,28,61,.459,27,50,.540,1,11,.091,14,20,.700,11,26,37,6,5,6,12,10,71,False,1128,Illinois
15,School Totals,199,22,47,.468,15,27,.556,7,20,.350,18,20,.900,4,24,28,15,7,2,15,12,69,False,2737,Illinois
11,School Totals,200,18,50,.360,16,36,.444,2,14,.143,18,23,.783,9,17,26,4,7,5,17,20,56,False,2738,Illinois
14,School Totals,200,36,68,.529,25,42,.595,11,26,.423,12,19,.632,12,24,36,22,7,5,8,17,95,False,2739,Illinois
14,School Totals,200,22,75,.293,19,47,.404,3,28,.107,9,15,.600,13,25,38,14,2,3,8,17,56,False,1503,Illinois
14,School Totals,200,26,57,.456,19,38,.500,7,19,.368,4,8,.500,9,32,41,14,5,4,13,16,63,False,2740,Illinois
10,School Totals,200,28,57,.491,21,41,.512,7,16,.438,8,15,.533,6,20,26,11,1,2,7,22,71,False,2741,Illinois
10,School Totals,200,18,63,.286,16,49,.327,2,14,.143,16,19,.842,13,31,44,7,2,4,7,12,54,False,2462,Illinois
9,School Totals,200,27,54,.500,18,30,.600,9,24,.375,12,15,.800,8,21,29,17,2,5,7,11,75,False,2742,Illinois
11,School Totals,200,27,49,.551,20,33,.606,7,16,.438,18,19,.947,9,25,34,18,1,3,13,17,79,False,2743,Illinois
10,School Totals,200,24,54,.444,20,43,.465,4,11,.364,12,16,.750,4,25,29,6,1,0,8,19,64,False,1137,Illinois
10,School Totals,200,21,63,.333,18,48,.375,3,15,.200,14,16,.875,11,30,41,10,4,5,8,17,59,False,2744,Illinois
9,School Totals,200,24,58,.414,16,36,.444,8,22,.364,9,11,.818,13,19,32,12,6,0,13,19,65,False,2745,Illinois
10,School Totals,200,22,61,.361,14,39,.359,8,22,.364,14,24,.583,14,25,39,11,4,1,11,17,66,False,745,Illinois
11,School Totals,200,22,60,.367,17,42,.405,5,18,.278,20,25,.800,13,23,36,9,10,1,13,16,69,False,1511,Illinois
11,School Totals,200,19,61,.311,11,33,.333,8,28,.286,11,15,.733,16,20,36,10,5,3,9,15,57,False,2468,Illinois
9,School Totals,200,24,54,.444,21,44,.477,3,10,.300,11,18,.611,9,28,37,8,5,3,9,16,62,False,2151,Illinois
9,School Totals,200,28,71,.394,23,52,.442,5,19,.263,10,17,.588,14,28,42,13,6,2,10,10,71,False,2746,Illinois
9,School Totals,200,27,58,.466,19,35,.543,8,23,.348,12,15,.800,13,28,41,19,1,2,7,15,74,False,2747,Illinois
9,School Totals,200,23,52,.442,19,40,.475,4,12,.333,17,24,.708,6,22,28,9,5,6,7,16,67,False,364,Illinois
13,School Totals,200,24,55,.436,18,33,.545,6,22,.273,9,10,.900,7,21,28,10,6,4,12,22,63,False,1850,Illinois
11,School Totals,200,30,61,.492,23,37,.622,7,24,.292,11,17,.647,11,16,27,20,6,2,5,19,78,False,2748,Illinois
15,School Totals,200,44,75,.587,27,44,.614,17,31,.548,17,24,.708,18,40,58,31,5,4,15,18,122,False,2749,Illinois
15,School Totals,200,36,60,.600,29,42,.690,7,18,.389,18,24,.750,15,37,52,16,6,3,18,14,97,False,2750,Illinois
11,School Totals,200,28,58,.483,22,43,.512,6,15,.400,15,24,.625,10,32,42,14,3,1,15,14,77,False,2751,Illinois
10,School Totals,200,26,59,.441,19,41,.463,7,18,.389,10,16,.625,9,24,33,16,3,4,12,20,69,False,2752,Illinois
10,School Totals,200,29,50,.580,22,39,.564,7,11,.636,18,24,.750,3,32,35,13,7,5,18,20,83,False,2753,Illinois
10,School Totals,200,29,55,.527,26,42,.619,3,13,.231,17,28,.607,2,18,20,10,9,2,13,25,78,False,2754,Illinois
14,School Totals,200,34,64,.531,27,45,.600,7,19,.368,17,25,.680,7,42,49,21,2,2,13,27,92,False,2755,Illinois
10,School Totals,200,34,63,.540,25,48,.521,9,15,.600,11,15,.733,8,24,32,20,4,0,13,26,88,False,2475,Illinois
11,School Totals,200,35,63,.556,30,47,.638,5,16,.313,23,28,.821,12,21,33,20,5,2,10,15,98,False,2159,Illinois
9,School Totals,200,24,54,.444,17,34,.500,7,20,.350,14,18,.778,7,31,38,15,5,2,11,9,69,False,376,Illinois
9,School Totals,200,25,52,.481,18,32,.563,7,20,.350,9,22,.409,5,31,36,17,6,6,11,15,66,False,2756,Illinois
13,School Totals,200,27,55,.491,16,28,.571,11,27,.407,16,21,.762,9,29,38,19,4,4,15,17,81,False,2757,Illinois
10,School Totals,200,25,61,.410,20,46,.435,5,15,.333,8,12,.667,8,26,34,15,7,2,8,13,63,False,765,Illinois
10,School Totals,200,29,60,.483,20,34,.588,9,26,.346,14,20,.700,10,18,28,15,6,1,10,20,81,False,1864,Illinois
13,School Totals,200,26,57,.456,19,34,.559,7,23,.304,20,28,.714,7,26,33,18,7,8,14,21,79,False,2161,Illinois
10,School Totals,200,29,58,.500,21,39,.538,8,19,.421,14,17,.824,8,28,36,15,6,1,12,14,80,False,2758,Illinois
10,School Totals,225,22,57,.386,15,38,.395,7,19,.368,24,32,.750,11,24,35,10,7,3,10,26,75,False,384,Illinois
10,School Totals,200,28,53,.528,23,37,.622,5,16,.313,14,21,.667,10,34,44,16,8,1,18,10,75,False,2759,Illinois
10,School Totals,225,28,58,.483,21,37,.568,7,21,.333,14,22,.636,8,27,35,15,6,8,12,19,77,False,2760,Illinois
10,School Totals,200,27,52,.519,19,31,.613,8,21,.381,11,22,.500,8,24,32,16,5,2,15,16,73,False,2761,Illinois
15,School Totals,200,37,66,.561,30,52,.577,7,14,.500,13,15,.867,8,27,35,27,9,2,9,13,94,False,2762,Illinois
10,School Totals,200,24,60,.400,19,43,.442,5,17,.294,19,34,.559,16,24,40,14,4,2,11,19,72,False,1535,Illinois
15,School Totals,200,30,62,.484,26,39,.667,4,23,.174,22,29,.759,12,31,43,13,8,2,14,19,86,False,2763,Illinois
9,School Totals,200,25,48,.521,20,39,.513,5,9,.556,19,27,.704,5,34,39,13,5,3,20,18,74,False,2764,Illinois
13,School Totals,200,30,64,.469,24,51,.471,6,13,.462,10,14,.714,11,29,40,9,5,2,12,20,76,False,1164,Illinois
9,School Totals,200,27,52,.519,23,40,.575,4,12,.333,15,24,.625,10,24,34,12,4,1,9,14,73,False,1871,Illinois
14,School Totals,200,32,61,.525,27,44,.614,5,17,.294,21,31,.677,16,25,41,16,8,1,14,21,90,False,2485,Illinois
10,School Totals,200,32,66,.485,29,51,.569,3,15,.200,15,20,.750,8,31,39,22,7,6,8,14,82,False,2765,Illinois
9,School Totals,225,29,64,.453,20,43,.465,9,21,.429,24,32,.750,13,27,40,15,5,2,10,23,91,False,1874,Illinois
15,School Totals,200,36,63,.571,34,57,.596,2,6,.333,4,8,.500,5,33,38,19,5,3,5,11,78,False,2766,Illinois
9,School Totals,200,22,49,.449,18,35,.514,4,14,.286,10,13,.769,4,20,24,14,5,2,17,18,58,False,2767,Illinois
9,School Totals,200,17,50,.340,12,23,.522,5,27,.185,11,16,.688,14,22,36,9,2,2,16,18,50,False,2768,Iowa
9,School Totals,200,18,57,.316,12,30,.400,6,27,.222,8,15,.533,12,22,34,11,7,4,14,12,50,False,2769,Iowa
10,School Totals,200,24,51,.471,12,26,.462,12,25,.480,8,12,.667,6,22,28,18,7,1,12,9,68,False,2770,Iowa
10,School Totals,200,20,63,.317,10,26,.385,10,37,.270,10,15,.667,8,18,26,13,7,1,15,18,60,False,2771,Iowa
8,School Totals,200,18,37,.486,13,19,.684,5,18,.278,16,20,.800,4,13,17,7,5,1,13,12,57,False,2772,Iowa
8,School Totals,200,28,56,.500,25,36,.694,3,20,.150,14,18,.778,14,28,42,18,3,0,15,13,73,False,2773,Iowa
9,School Totals,200,22,49,.449,10,22,.455,12,27,.444,8,10,.800,5,20,25,19,2,0,11,14,64,False,2774,Iowa
11,School Totals,200,25,53,.472,10,22,.455,15,31,.484,15,23,.652,8,30,38,21,8,3,19,21,80,False,2775,Iowa
10,School Totals,200,19,46,.413,10,20,.500,9,26,.346,3,8,.375,4,20,24,10,2,1,16,17,50,False,2776,Iowa
10,School Totals,200,26,56,.464,15,30,.500,11,26,.423,8,11,.727,6,18,24,12,3,0,12,21,71,False,2777,Iowa
9,School Totals,200,23,50,.460,11,21,.524,12,29,.414,13,23,.565,6,28,34,16,2,2,8,16,71,False,2778,Iowa
9,School Totals,200,29,51,.569,22,31,.710,7,20,.350,17,24,.708,6,22,28,16,6,1,10,11,82,False,2779,Iowa
9,School Totals,200,21,51,.412,15,35,.429,6,16,.375,8,11,.727,10,17,27,11,3,3,16,18,56,False,2780,Iowa
10,School Totals,200,26,58,.448,15,32,.469,11,26,.423,11,16,.688,10,25,35,15,3,2,24,14,74,False,2781,Iowa
11,School Totals,200,15,49,.306,9,21,.429,6,28,.214,6,8,.750,5,20,25,11,2,3,14,14,42,False,2502,Iowa
11,School Totals,200,20,51,.392,14,29,.483,6,22,.273,7,11,.636,8,11,19,9,4,1,16,15,53,False,1187,Iowa
10,School Totals,200,23,46,.500,16,25,.640,7,21,.333,14,17,.824,8,22,30,16,6,0,15,11,67,False,2782,Iowa
10,School Totals,200,21,50,.420,14,25,.560,7,25,.280,18,25,.720,11,20,31,16,4,2,8,17,67,False,1891,Iowa
10,School Totals,200,23,56,.411,16,31,.516,7,25,.280,10,13,.769,6,21,27,12,8,4,14,19,63,False,1190,Iowa
10,School Totals,200,22,48,.458,17,34,.500,5,14,.357,9,15,.600,17,17,34,9,6,4,20,16,58,False,18,Iowa
10,School Totals,200,20,55,.364,10,24,.417,10,31,.323,7,10,.700,10,24,34,13,1,3,10,18,57,False,1556,Iowa
10,School Totals,200,17,55,.309,13,31,.419,4,24,.167,8,10,.800,9,19,28,5,4,4,10,17,46,False,802,Iowa
10,School Totals,200,16,54,.296,8,26,.308,8,28,.286,9,12,.750,13,24,37,13,4,1,10,11,49,False,2505,Iowa
9,School Totals,200,20,47,.426,12,27,.444,8,20,.400,10,16,.625,8,18,26,8,3,1,14,22,58,False,1559,Iowa
10,School Totals,200,23,46,.500,11,22,.500,12,24,.500,20,30,.667,7,27,34,18,4,1,8,17,78,False,2783,Iowa
11,School Totals,200,14,47,.298,7,23,.304,7,24,.292,5,8,.625,5,22,27,8,4,2,15,17,40,False,2784,Iowa
9,School Totals,225,28,60,.467,18,38,.474,10,22,.455,12,16,.750,11,23,34,14,5,2,11,17,78,False,806,Iowa
11,School Totals,200,17,43,.395,14,22,.636,3,21,.143,20,25,.800,8,16,24,10,4,4,13,22,57,False,2785,Iowa
10,School Totals,200,22,48,.458,19,31,.613,3,17,.176,26,38,.684,11,17,28,9,7,3,11,24,73,False,27,Iowa
11,School Totals,200,16,43,.372,13,28,.464,3,15,.200,5,10,.500,4,15,19,6,3,2,12,6,40,False,2786,Iowa
11,School Totals,200,20,47,.426,16,30,.533,4,17,.235,9,13,.692,5,13,18,12,1,2,14,12,53,False,2787,Iowa
10,School Totals,200,22,56,.393,17,36,.472,5,20,.250,3,4,.750,10,23,33,9,4,4,13,16,52,False,812,Iowa
10,School Totals,200,24,59,.407,21,49,.429,3,10,.300,18,25,.720,9,31,40,10,3,2,18,17,69,False,2788,Iowa
14,School Totals,200,28,60,.467,20,39,.513,8,21,.381,4,10,.400,12,28,40,17,10,4,22,13,68,False,2789,Iowa
12,School Totals,200,24,68,.353,19,46,.413,5,22,.227,20,28,.714,18,18,36,11,3,0,10,28,73,False,2790,Iowa
12,School Totals,200,15,42,.357,10,30,.333,5,12,.417,20,32,.625,9,23,32,5,7,2,16,14,55,False,2791,Iowa
12,School Totals,200,28,59,.475,24,44,.545,4,15,.267,12,18,.667,6,23,29,10,7,4,14,17,72,False,2792,Iowa
14,School Totals,200,37,63,.587,27,45,.600,10,18,.556,27,38,.711,16,25,41,24,19,2,13,8,111,False,2793,Iowa
12,School Totals,200,31,71,.437,27,52,.519,4,19,.211,7,10,.700,14,19,33,15,10,2,15,21,73,False,2794,Iowa
11,School Totals,200,27,61,.443,23,40,.575,4,21,.190,12,22,.545,17,19,36,20,14,2,13,18,70,False,2795,Iowa
9,School Totals,200,18,45,.400,15,33,.455,3,12,.250,12,23,.522,11,28,39,12,2,2,8,10,51,False,2796,Iowa
10,School Totals,200,26,64,.406,18,47,.383,8,17,.471,12,23,.522,18,27,45,15,6,7,17,15,72,False,2797,Iowa
11,School Totals,200,19,45,.422,15,29,.517,4,16,.250,17,25,.680,8,26,34,8,9,1,18,15,59,False,2798,Iowa
10,School Totals,200,25,57,.439,16,35,.457,9,22,.409,18,23,.783,8,27,35,17,9,4,12,17,77,False,2799,Iowa
11,School Totals,200,30,64,.469,21,40,.525,9,24,.375,8,15,.533,13,12,25,13,7,0,13,16,77,False,2526,Iowa
9,School Totals,200,25,59,.424,18,44,.409,7,15,.467,11,14,.786,13,17,30,15,5,6,15,14,68,False,1582,Iowa
11,School Totals,200,19,52,.365,17,45,.378,2,7,.286,12,16,.750,8,20,28,11,5,6,16,14,52,False,2800,Iowa
13,School Totals,200,26,50,.520,19,33,.576,7,17,.412,12,22,.545,7,18,25,11,10,6,15,15,71,False,2801,Iowa
10,School Totals,200,22,59,.373,16,40,.400,6,19,.316,9,11,.818,9,19,28,12,6,2,10,22,59,False,2802,Iowa
11,School Totals,200,22,55,.400,21,48,.438,1,7,.143,3,4,.750,8,17,25,12,5,3,22,18,48,False,1585,Iowa
11,School Totals,200,30,52,.577,26,42,.619,4,10,.400,27,39,.692,10,28,38,16,8,4,19,24,91,False,50,Iowa
9,School Totals,200,19,51,.373,12,33,.364,7,18,.389,6,9,.667,8,11,19,13,8,0,10,14,51,False,1913,Iowa
10,School Totals,200,28,57,.491,23,44,.523,5,13,.385,12,17,.706,9,16,25,15,3,3,10,15,73,False,834,Iowa
10,School Totals,200,30,52,.577,27,43,.628,3,9,.333,9,11,.818,5,24,29,19,7,5,12,14,72,False,1224,Iowa
10,School Totals,200,21,44,.477,19,35,.543,2,9,.222,20,25,.800,9,21,30,12,5,4,17,15,64,False,54,Iowa
9,School Totals,225,25,60,.417,24,53,.453,1,7,.143,8,9,.889,10,28,38,14,4,4,10,10,59,False,2803,Iowa
10,School Totals,200,16,47,.340,10,19,.526,6,28,.214,7,11,.636,8,16,24,12,6,4,17,18,45,False,2804,Iowa
11,School Totals,200,30,58,.517,25,46,.543,5,12,.417,5,12,.417,11,23,34,16,1,1,12,16,70,False,2805,Iowa
10,School Totals,225,26,58,.448,24,41,.585,2,17,.118,18,22,.818,12,21,33,15,7,0,16,22,72,False,839,Iowa
9,School Totals,200,24,59,.407,19,42,.452,5,17,.294,15,18,.833,11,15,26,15,5,3,14,13,68,False,2533,Iowa
10,School Totals,200,23,56,.411,23,44,.523,0,12,.000,20,33,.606,9,20,29,12,7,3,11,23,66,False,1231,Iowa
10,School Totals,200,26,60,.433,23,50,.460,3,10,.300,12,19,.632,12,35,47,15,2,2,13,16,67,False,2806,Iowa
11,School Totals,200,22,56,.393,18,47,.383,4,9,.444,13,17,.765,13,16,29,11,8,1,13,16,61,False,1232,Iowa
16,School Totals,200,30,70,.429,21,43,.488,9,27,.333,27,32,.844,16,25,41,22,14,1,9,13,96,False,2807,Iowa
11,School Totals,200,33,67,.493,24,41,.585,9,26,.346,20,27,.741,17,33,50,20,7,2,22,22,95,False,2808,Iowa
16,School Totals,200,33,61,.541,20,40,.500,13,21,.619,9,13,.692,9,23,32,26,10,2,9,13,88,False,2809,Iowa
13,School Totals,200,21,59,.356,14,38,.368,7,21,.333,10,19,.526,10,17,27,10,10,3,8,14,59,False,2810,Iowa
11,School Totals,200,24,66,.364,21,55,.382,3,11,.273,10,12,.833,14,14,28,10,10,2,14,21,61,False,2811,Iowa
11,School Totals,200,28,51,.549,23,40,.575,5,11,.455,21,33,.636,6,19,25,17,13,0,15,19,82,False,2812,Iowa
15,School Totals,200,16,56,.286,13,45,.289,3,11,.273,20,22,.909,6,17,23,5,8,3,10,11,55,False,2813,Iowa
14,School Totals,200,28,69,.406,26,59,.441,2,10,.200,17,24,.708,18,31,49,15,8,3,9,17,75,False,2814,Iowa
11,School Totals,200,28,55,.509,27,43,.628,1,12,.083,3,9,.333,6,24,30,10,5,0,12,25,60,False,2815,Iowa
10,School Totals,200,24,56,.429,18,43,.419,6,13,.462,22,25,.880,8,21,29,12,6,0,12,24,76,False,2816,Iowa
10,School Totals,200,28,56,.500,25,43,.581,3,13,.231,23,29,.793,13,18,31,16,12,6,12,17,82,False,2817,Iowa
18,School Totals,200,42,76,.553,37,63,.587,5,13,.385,16,21,.762,16,34,50,32,12,7,14,15,105,False,2818,Iowa
10,School Totals,200,26,54,.481,22,42,.524,4,12,.333,25,31,.806,9,24,33,14,6,8,5,11,81,False,2819,Iowa
10,School Totals,200,26,55,.473,23,44,.523,3,11,.273,21,29,.724,7,25,32,15,1,4,10,13,76,False,2820,Iowa
11,School Totals,200,29,59,.492,27,53,.509,2,6,.333,12,17,.706,11,29,40,10,2,4,10,17,72,False,2821,Iowa
11,School Totals,200,23,50,.460,19,38,.500,4,12,.333,14,24,.583,12,15,27,12,10,1,12,13,64,False,2822,Iowa
15,School Totals,200,17,53,.321,14,41,.341,3,12,.250,10,13,.769,7,22,29,7,10,6,20,10,47,False,1615,Iowa
13,School Totals,200,23,63,.365,19,49,.388,4,14,.286,11,19,.579,16,14,30,12,8,4,21,15,61,False,1251,Iowa
11,School Totals,200,25,54,.463,20,42,.476,5,12,.417,20,28,.714,10,25,35,18,8,1,8,17,75,False,863,Iowa
11,School Totals,200,22,49,.449,17,37,.459,5,12,.417,19,30,.633,6,22,28,10,6,5,13,25,68,False,2823,Iowa
11,School Totals,200,27,55,.491,21,36,.583,6,19,.316,13,18,.722,10,17,27,11,7,4,8,18,73,False,2824,Iowa
15,School Totals,200,34,54,.630,26,39,.667,8,15,.533,13,21,.619,6,12,18,16,6,6,17,23,89,False,84,Iowa
10,School Totals,200,21,56,.375,17,42,.405,4,14,.286,17,26,.654,15,22,37,13,11,3,10,13,63,False,2825,Iowa
10,School Totals,200,22,48,.458,18,35,.514,4,13,.308,29,34,.853,8,29,37,16,7,5,14,12,77,False,1942,Iowa
14,School Totals,200,23,45,.511,16,31,.516,7,14,.500,11,15,.733,8,18,26,14,2,2,18,20,64,False,2826,Iowa
10,School Totals,200,20,49,.408,14,31,.452,6,18,.333,18,27,.667,9,22,31,13,6,7,12,18,64,False,1944,Iowa
12,School Totals,200,27,63,.429,18,45,.400,9,18,.500,15,21,.714,15,22,37,12,9,7,10,18,78,False,89,Iowa
11,School Totals,200,24,50,.480,14,32,.438,10,18,.556,9,15,.600,7,20,27,18,6,4,13,12,67,False,2827,Iowa
11,School Totals,200,18,49,.367,12,32,.375,6,17,.353,12,16,.750,5,16,21,12,7,1,17,17,54,False,2558,Iowa
10,School Totals,200,22,49,.449,14,29,.483,8,20,.400,10,16,.625,6,24,30,15,4,0,13,15,62,False,2828,Iowa
11,School Totals,200,22,40,.550,17,24,.708,5,16,.313,17,22,.773,5,22,27,16,6,3,18,20,66,False,2829,Iowa
10,School Totals,200,23,57,.404,17,38,.447,6,19,.316,12,19,.632,14,20,34,15,9,3,6,10,64,False,2560,Iowa
11,School Totals,200,23,53,.434,13,33,.394,10,20,.500,19,26,.731,5,16,21,15,7,7,9,21,75,False,1263,Iowa
10,School Totals,200,33,58,.569,27,42,.643,6,16,.375,12,15,.800,9,25,34,23,3,5,10,12,84,False,2830,Iowa
12,School Totals,200,37,79,.468,27,57,.474,10,22,.455,13,15,.867,15,15,30,19,6,0,8,23,97,False,2831,Iowa
15,School Totals,200,31,69,.449,24,53,.453,7,16,.438,17,25,.680,17,30,47,18,13,10,13,12,86,False,2832,Iowa
11,School Totals,200,26,58,.448,19,39,.487,7,19,.368,14,23,.609,14,21,35,16,7,5,15,16,73,False,2833,Iowa
15,School Totals,200,22,49,.449,18,28,.643,4,21,.190,18,25,.720,11,29,40,16,3,5,11,16,66,False,2834,Iowa
11,School Totals,200,19,53,.358,13,32,.406,6,21,.286,21,32,.656,16,24,40,12,11,6,14,16,65,False,2835,Iowa
11,School Totals,200,22,47,.468,18,35,.514,4,12,.333,15,20,.750,8,26,34,11,6,6,18,18,63,False,2836,Iowa
12,School Totals,200,12,46,.261,4,31,.129,8,15,.533,31,39,.795,7,20,27,7,2,5,14,22,63,False,2837,Iowa
12,School Totals,200,31,64,.484,27,42,.643,4,22,.182,13,18,.722,8,22,30,16,2,4,10,23,79,False,2838,Iowa
15,School Totals,200,29,52,.558,21,33,.636,8,19,.421,22,29,.759,12,24,36,22,4,4,13,13,88,False,2839,Iowa
15,School Totals,200,34,76,.447,32,60,.533,2,16,.125,17,19,.895,20,30,50,20,8,4,11,17,87,False,2840,Iowa
11,School Totals,200,30,65,.462,25,45,.556,5,20,.250,15,18,.833,11,21,32,21,10,2,12,14,80,False,2841,Iowa
11,School Totals,200,21,49,.429,9,24,.375,12,25,.480,26,37,.703,8,27,35,18,5,7,15,19,80,False,2842,Iowa
14,School Totals,200,31,63,.492,20,40,.500,11,23,.478,17,27,.630,14,41,55,22,10,6,12,13,90,False,2843,Iowa
15,School Totals,200,31,60,.517,31,43,.721,0,17,.000,18,31,.581,15,35,50,21,9,5,20,10,80,False,2844,Iowa
11,School Totals,200,21,63,.333,18,46,.391,3,17,.176,20,26,.769,9,27,36,14,11,4,12,15,65,False,112,Iowa
12,School Totals,200,27,62,.435,20,42,.476,7,20,.350,6,10,.600,6,20,26,17,3,1,7,18,67,False,893,Iowa
11,School Totals,200,23,51,.451,19,35,.543,4,16,.250,9,15,.600,6,28,34,18,5,4,18,17,59,False,1284,Iowa
15,School Totals,200,29,63,.460,25,47,.532,4,16,.250,8,12,.667,8,31,39,22,7,1,8,18,70,False,2845,Iowa
11,School Totals,200,22,51,.431,20,41,.488,2,10,.200,24,29,.828,7,24,31,6,8,2,6,16,70,False,2846,Iowa
12,School Totals,200,22,62,.355,16,44,.364,6,18,.333,13,26,.500,19,15,34,8,4,1,14,20,63,False,1646,Iowa
11,School Totals,225,19,61,.311,14,44,.318,5,17,.294,19,27,.704,10,26,36,15,6,8,10,21,62,False,2847,Iowa
11,School Totals,200,20,50,.400,15,29,.517,5,21,.238,31,39,.795,13,23,36,18,11,6,13,15,76,False,1964,Iowa
11,School Totals,200,21,58,.362,14,35,.400,7,23,.304,10,17,.588,12,15,27,17,8,2,10,21,59,False,2848,Iowa
11,School Totals,250,25,74,.338,20,51,.392,5,23,.217,15,22,.682,12,32,44,16,7,2,12,24,70,False,2849,Iowa
15,School Totals,200,24,50,.480,20,38,.526,4,12,.333,19,22,.864,7,24,31,16,5,4,12,17,71,False,2850,Iowa
11,School Totals,200,24,54,.444,18,33,.545,6,21,.286,20,26,.769,11,24,35,15,5,7,13,19,74,False,1967,Iowa
15,School Totals,200,21,43,.488,16,34,.471,5,9,.556,25,31,.806,8,21,29,9,12,6,12,18,72,False,2851,Iowa
11,School Totals,200,21,57,.368,16,42,.381,5,15,.333,13,15,.867,12,26,38,11,7,4,12,14,60,False,2852,Iowa
11,School Totals,200,16,51,.314,11,38,.289,5,13,.385,21,29,.724,13,24,37,8,10,5,9,15,58,False,2853,Iowa
11,School Totals,200,21,55,.382,20,42,.476,1,13,.077,17,24,.708,13,21,34,9,7,5,18,27,60,False,127,Iowa
10,School Totals,200,21,54,.389,16,36,.444,5,18,.278,16,20,.800,7,28,35,15,5,13,13,15,63,False,2585,Iowa
14,School Totals,200,28,49,.571,23,35,.657,5,14,.357,13,15,.867,11,26,37,21,2,7,12,11,74,False,2854,Iowa
11,School Totals,200,23,62,.371,17,45,.378,6,17,.353,21,32,.656,16,28,44,15,6,8,7,16,73,False,2855,Iowa
11,School Totals,200,20,44,.455,15,26,.577,5,18,.278,11,12,.917,5,19,24,10,10,7,17,16,56,False,1296,Iowa
15,School Totals,200,22,57,.386,16,38,.421,6,19,.316,18,26,.692,15,24,39,11,9,4,13,13,68,False,2856,Iowa
11,School Totals,200,26,55,.473,18,36,.500,8,19,.421,15,21,.714,10,23,33,20,5,5,8,18,75,False,2857,Iowa
11,School Totals,200,26,53,.491,18,36,.500,8,17,.471,15,15,1.000,7,22,29,14,8,3,15,17,75,False,2858,Iowa
11,School Totals,200,24,57,.421,20,45,.444,4,12,.333,19,24,.792,9,21,30,17,7,5,6,17,71,False,529,Iowa
15,School Totals,200,18,69,.261,13,45,.289,5,24,.208,13,18,.722,17,19,36,11,5,0,11,20,54,False,2859,Iowa
15,School Totals,200,31,67,.463,27,55,.491,4,12,.333,16,24,.667,13,40,53,19,7,12,10,10,82,False,2860,Iowa
11,School Totals,200,21,56,.375,18,42,.429,3,14,.214,38,49,.776,17,29,46,12,7,7,18,15,83,False,2861,Iowa
15,School Totals,200,35,68,.515,28,51,.549,7,17,.412,32,43,.744,17,38,55,24,8,6,12,18,109,False,2862,Iowa
14,School Totals,200,38,61,.623,29,40,.725,9,21,.429,18,22,.818,5,30,35,25,11,5,5,10,103,False,2863,Iowa
15,School Totals,200,26,66,.394,20,48,.417,6,18,.333,28,40,.700,17,25,42,11,14,5,10,17,86,False,2864,Iowa
11,School Totals,225,24,68,.353,18,45,.400,6,23,.261,23,34,.676,18,23,41,17,6,8,12,22,77,False,2865,Iowa
15,School Totals,200,31,59,.525,22,43,.512,9,16,.563,18,22,.818,12,32,44,22,2,4,5,17,89,False,2866,Iowa
11,School Totals,225,29,69,.420,18,45,.400,11,24,.458,14,21,.667,6,23,29,18,8,6,17,28,83,False,2867,Iowa
11,School Totals,200,33,58,.569,26,45,.578,7,13,.538,25,29,.862,11,24,35,20,3,5,12,15,98,False,2868,Iowa
15,School Totals,200,29,64,.453,26,46,.565,3,18,.167,22,30,.733,17,30,47,11,5,6,5,15,83,False,2869,Iowa
15,School Totals,200,34,70,.486,30,59,.508,4,11,.364,20,27,.741,16,33,49,19,8,3,8,13,92,False,2870,Iowa
12,School Totals,200,32,69,.464,28,52,.538,4,17,.235,14,21,.667,13,34,47,19,6,1,11,27,82,False,2871,Iowa
16,School Totals,200,29,47,.617,19,30,.633,10,17,.588,18,27,.667,10,30,40,22,10,4,27,12,86,False,2872,Iowa
12,School Totals,200,22,48,.458,21,42,.500,1,6,.167,22,39,.564,8,30,38,10,6,8,15,17,67,False,2873,Iowa
11,School Totals,200,25,64,.391,21,54,.389,4,10,.400,17,25,.680,13,26,39,10,7,5,10,23,71,False,2874,Iowa
14,School Totals,200,29,51,.569,21,37,.568,8,14,.571,27,36,.750,9,31,40,22,10,6,15,20,93,False,2875,Iowa
11,School Totals,200,29,61,.475,24,44,.545,5,17,.294,21,26,.808,11,27,38,14,5,4,9,18,84,False,1675,Iowa
12,School Totals,200,29,59,.492,20,39,.513,9,20,.450,27,37,.730,13,25,38,12,6,1,10,21,94,False,2876,Iowa
11,School Totals,200,25,53,.472,23,43,.535,2,10,.200,15,21,.714,9,23,32,14,6,2,14,17,67,False,933,Iowa
16,School Totals,200,28,54,.519,23,42,.548,5,12,.417,15,20,.750,9,30,39,17,7,3,13,12,76,False,2877,Iowa
11,School Totals,225,18,48,.375,15,36,.417,3,12,.250,30,43,.698,7,28,35,7,4,5,10,19,69,False,1318,Iowa
12,School Totals,200,26,56,.464,21,40,.525,5,16,.313,24,30,.800,15,24,39,13,10,5,15,22,81,False,2605,Iowa
12,School Totals,200,27,60,.450,24,40,.600,3,20,.150,12,19,.632,13,22,35,11,3,5,13,20,69,False,1681,Iowa
15,School Totals,200,29,61,.475,19,44,.432,10,17,.588,17,22,.773,15,23,38,22,9,7,7,14,85,False,937,Iowa
10,School Totals,200,22,55,.400,15,36,.417,7,19,.368,31,40,.775,11,25,36,13,4,10,6,18,82,False,1991,Iowa
12,School Totals,201,31,64,.484,27,50,.540,4,14,.286,8,9,.889,11,22,33,19,5,3,7,15,74,False,2878,Iowa
12,School Totals,200,31,64,.484,21,39,.538,10,25,.400,17,22,.773,11,14,25,17,9,4,13,25,89,False,2879,Iowa
13,School Totals,200,34,70,.486,30,50,.600,4,20,.200,14,22,.636,16,24,40,17,10,5,18,26,86,False,162,Iowa
11,School Totals,192,26,60,.433,21,44,.477,5,16,.313,26,36,.722,9,21,30,17,12,5,5,18,83,False,2880,Iowa
14,School Totals,200,28,60,.467,21,40,.525,7,20,.350,13,15,.867,7,11,18,15,10,1,13,20,76,False,1326,Iowa
12,School Totals,200,24,54,.444,18,37,.486,6,17,.353,9,14,.643,10,16,26,16,7,6,8,13,63,False,2610,Iowa
12,School Totals,200,20,62,.323,14,38,.368,6,24,.250,16,18,.889,15,16,31,13,7,5,9,16,62,False,2881,Iowa
12,School Totals,225,24,58,.414,20,42,.476,4,16,.250,13,15,.867,7,22,29,14,2,2,6,28,65,False,2882,Iowa
14,School Totals,200,29,61,.475,20,40,.500,9,21,.429,23,33,.697,15,29,44,20,9,7,14,14,90,False,2883,Iowa
14,School Totals,200,30,56,.536,21,36,.583,9,20,.450,18,20,.900,6,36,42,20,10,4,18,18,87,False,2884,Iowa
11,School Totals,200,16,54,.296,12,40,.300,4,14,.286,21,28,.750,12,22,34,11,10,4,14,18,57,False,2885,Iowa
11,School Totals,200,22,55,.400,16,34,.471,6,21,.286,13,20,.650,10,23,33,16,6,6,18,16,63,False,2886,Iowa
10,School Totals,200,25,61,.410,20,47,.426,5,14,.357,17,26,.654,12,23,35,15,12,2,12,19,72,False,2887,Iowa
13,School Totals,200,25,54,.463,20,37,.541,5,17,.294,15,19,.789,14,20,34,16,8,12,13,15,70,False,2888,Iowa
15,School Totals,200,31,71,.437,22,41,.537,9,30,.300,6,9,.667,12,26,38,21,10,9,7,11,77,False,2889,Iowa
11,School Totals,200,18,55,.327,15,35,.429,3,20,.150,21,24,.875,15,24,39,9,3,6,12,20,60,False,2890,Iowa
15,School Totals,200,29,65,.446,22,40,.550,7,25,.280,12,15,.800,11,24,35,20,16,5,11,11,77,False,2891,Iowa
14,School Totals,200,24,57,.421,21,38,.553,3,19,.158,16,22,.727,13,31,44,14,3,3,10,12,67,False,2892,Iowa
11,School Totals,200,28,71,.394,21,51,.412,7,20,.350,12,13,.923,9,27,36,16,3,6,7,15,75,False,2893,Iowa
12,School Totals,200,14,51,.275,11,39,.282,3,12,.250,13,18,.722,11,22,33,8,5,2,13,17,44,False,2894,Iowa
11,School Totals,200,23,60,.383,15,40,.375,8,20,.400,26,28,.929,12,25,37,17,11,6,13,15,80,False,2895,Iowa
11,School Totals,200,23,50,.460,15,28,.536,8,22,.364,17,23,.739,14,22,36,17,2,4,13,19,71,False,1703,Iowa
10,School Totals,200,17,44,.386,12,24,.500,5,20,.250,31,38,.816,9,22,31,11,7,3,9,18,70,False,2896,Iowa
10,School Totals,200,22,51,.431,20,39,.513,2,12,.167,15,24,.625,7,21,28,12,4,4,8,14,61,False,1347,Iowa
10,School Totals,200,25,48,.521,17,32,.531,8,16,.500,19,27,.704,12,19,31,16,7,9,14,17,77,False,2897,Iowa
10,School Totals,200,24,47,.511,21,38,.553,3,9,.333,25,35,.714,9,26,35,8,7,3,9,19,76,False,1706,Iowa
11,School Totals,200,20,46,.435,14,31,.452,6,15,.400,4,10,.400,5,17,22,7,0,4,9,16,50,False,2898,Iowa
11,School Totals,200,21,64,.328,17,47,.362,4,17,.235,17,26,.654,21,20,41,10,3,2,7,20,63,False,2899,Iowa
10,School Totals,200,23,48,.479,19,41,.463,4,7,.571,13,20,.650,7,17,24,11,4,3,8,21,63,False,2900,Iowa
10,School Totals,200,32,51,.627,28,40,.700,4,11,.364,4,6,.667,8,22,30,16,2,2,6,10,72,False,973,Iowa
9,School Totals,200,27,42,.643,22,31,.710,5,11,.455,12,16,.750,3,21,24,18,6,2,19,17,71,False,584,Iowa
10,School Totals,200,21,49,.429,17,35,.486,4,14,.286,13,16,.813,8,26,34,14,2,6,15,17,59,False,2901,Iowa
10,School Totals,225,20,62,.323,12,38,.316,8,24,.333,13,20,.650,11,22,33,15,5,4,4,15,61,False,2902,Iowa
14,School Totals,200,30,59,.508,22,42,.524,8,17,.471,13,22,.591,10,26,36,19,13,2,11,11,81,False,2352,Iowa
13,School Totals,200,29,58,.500,24,48,.500,5,10,.500,11,13,.846,10,26,36,17,8,4,7,15,74,False,2903,Iowa
10,School Totals,200,21,48,.438,15,34,.441,6,14,.429,20,30,.667,10,24,34,14,6,6,12,14,68,False,2631,Iowa
10,School Totals,225,24,67,.358,16,46,.348,8,21,.381,25,27,.926,12,25,37,14,11,2,10,20,81,False,2021,Iowa
10,School Totals,200,25,54,.463,21,42,.500,4,12,.333,23,28,.821,9,24,33,11,8,6,10,15,77,False,196,Iowa
13,School Totals,200,25,60,.417,17,35,.486,8,25,.320,11,16,.688,14,24,38,18,8,4,6,11,69,False,2904,Iowa
10,School Totals,200,15,57,.263,12,42,.286,3,15,.200,25,31,.806,14,23,37,9,2,8,12,18,58,False,2024,Iowa
13,School Totals,200,35,69,.507,29,53,.547,6,16,.375,7,10,.700,13,29,42,12,3,5,5,11,83,False,2905,Iowa
10,School Totals,200,28,60,.467,23,45,.511,5,15,.333,7,10,.700,4,15,19,10,4,3,11,17,68,False,2906,Iowa
14,School Totals,200,24,59,.407,17,35,.486,7,24,.292,21,28,.750,14,29,43,15,8,6,14,19,76,False,2907,Iowa
15,School Totals,200,40,72,.556,28,44,.636,12,28,.429,11,20,.550,9,40,49,31,5,6,11,18,103,False,2908,Iowa
14,School Totals,200,36,66,.545,24,44,.545,12,22,.545,5,7,.714,7,26,33,25,14,2,12,17,89,False,2909,Iowa
13,School Totals,200,27,62,.435,15,38,.395,12,24,.500,11,17,.647,9,22,31,19,6,3,12,22,77,False,2910,Iowa
13,School Totals,200,25,66,.379,19,42,.452,6,24,.250,6,9,.667,12,23,35,13,4,6,6,19,62,False,2911,Iowa
12,School Totals,200,28,52,.538,20,34,.588,8,18,.444,20,24,.833,9,21,30,16,4,5,11,18,84,False,2912,Iowa
10,School Totals,225,27,64,.422,22,43,.512,5,21,.238,19,26,.731,11,25,36,15,9,4,12,17,78,False,2913,Iowa
15,School Totals,200,34,72,.472,22,47,.468,12,25,.480,15,19,.789,14,25,39,22,6,8,6,15,95,False,2914,Iowa
15,School Totals,200,33,66,.500,23,43,.535,10,23,.435,14,19,.737,10,29,39,20,10,6,11,11,90,False,2915,Iowa
9,School Totals,200,31,65,.477,20,38,.526,11,27,.407,9,10,.900,8,24,32,18,4,6,14,14,82,False,2916,Iowa
10,School Totals,200,28,60,.467,20,39,.513,8,21,.381,6,8,.750,7,22,29,12,4,14,2,12,70,False,2917,Iowa
15,School Totals,200,32,70,.457,21,40,.525,11,30,.367,10,13,.769,11,28,39,19,8,4,10,15,85,False,2918,Iowa
10,School Totals,200,27,56,.482,21,43,.488,6,13,.462,23,31,.742,8,19,27,15,8,11,12,20,83,False,1379,Iowa
10,School Totals,200,25,58,.431,18,39,.462,7,19,.368,13,20,.650,9,23,32,14,10,9,8,16,70,False,2919,Iowa
10,School Totals,200,23,53,.434,16,36,.444,7,17,.412,24,32,.750,8,24,32,14,4,7,7,15,77,False,2920,Iowa
11,School Totals,200,28,65,.431,18,43,.419,10,22,.455,10,16,.625,13,24,37,15,7,4,9,16,76,False,1383,Iowa
10,School Totals,200,31,61,.508,21,39,.538,10,22,.455,10,11,.909,6,20,26,19,8,3,4,13,82,False,997,Iowa
11,School Totals,200,31,65,.477,20,36,.556,11,29,.379,17,21,.810,9,26,35,19,7,6,8,11,90,False,2371,Iowa
10,School Totals,200,27,54,.500,16,34,.471,11,20,.550,18,28,.643,4,27,31,17,9,4,11,20,83,False,2921,Iowa
10,School Totals,200,27,63,.429,22,39,.564,5,24,.208,9,15,.600,8,25,33,9,4,2,11,21,68,False,614,Iowa
12,School Totals,200,25,59,.424,18,40,.450,7,19,.368,28,36,.778,10,24,34,10,12,4,10,11,85,False,2922,Iowa
15,School Totals,200,25,54,.463,19,37,.514,6,17,.353,17,26,.654,9,34,43,12,5,8,11,16,73,False,2043,Iowa
10,School Totals,200,28,65,.431,20,45,.444,8,20,.400,13,16,.813,12,30,42,11,7,2,8,12,77,False,2653,Iowa
10,School Totals,200,29,63,.460,22,45,.489,7,18,.389,13,23,.565,18,15,33,13,6,1,9,18,78,False,225,Iowa
10,School Totals,200,24,57,.421,18,38,.474,6,19,.316,21,30,.700,9,28,37,17,2,7,8,21,75,False,2923,Iowa
10,School Totals,200,21,51,.412,13,27,.481,8,24,.333,25,35,.714,8,23,31,11,5,2,12,20,75,False,2045,Iowa
10,School Totals,200,18,55,.327,13,37,.351,5,18,.278,18,25,.720,18,21,39,9,8,3,14,17,59,False,2924,Iowa
11,School Totals,200,22,54,.407,19,42,.452,3,12,.250,17,22,.773,8,19,27,11,7,0,13,17,64,False,1742,Iowa
10,School Totals,200,26,67,.388,18,48,.375,8,19,.421,18,27,.667,18,21,39,16,6,2,9,17,78,False,230,Iowa
10,School Totals,200,28,62,.452,20,34,.588,8,28,.286,7,10,.700,4,28,32,19,7,3,8,15,71,False,1008,Iowa
10,School Totals,200,25,62,.403,17,42,.405,8,20,.400,8,10,.800,13,22,35,20,7,2,17,11,66,False,2658,Iowa
10,School Totals,225,24,69,.348,17,41,.415,7,28,.250,17,22,.773,11,25,36,13,6,3,3,15,72,False,2925,Iowa
15,School Totals,200,27,60,.450,20,36,.556,7,24,.292,7,13,.538,8,18,26,14,6,3,13,19,68,False,2926,Iowa
13,School Totals,200,30,60,.500,23,38,.605,7,22,.318,24,34,.706,11,28,39,17,9,8,17,21,91,False,2927,Iowa
14,School Totals,200,42,87,.483,24,44,.545,18,43,.419,14,20,.700,18,32,50,33,6,5,15,20,116,False,2928,Iowa
12,School Totals,200,28,61,.459,20,40,.500,8,21,.381,19,32,.594,11,34,45,16,9,3,17,24,83,False,2929,Iowa
14,School Totals,200,32,63,.508,21,34,.618,11,29,.379,20,30,.667,8,27,35,22,10,4,16,12,95,False,2930,Iowa
13,School Totals,200,15,48,.313,9,25,.360,6,23,.261,5,10,.500,11,19,30,8,3,2,18,17,41,False,2931,Iowa
11,School Totals,200,30,55,.545,19,32,.594,11,23,.478,21,24,.875,6,24,30,16,6,4,18,17,92,False,2932,Iowa
11,School Totals,200,27,71,.380,15,36,.417,12,35,.343,12,16,.750,10,18,28,22,8,2,6,22,78,False,2933,Iowa
12,School Totals,200,27,67,.403,13,33,.394,14,34,.412,21,27,.778,16,21,37,17,4,8,15,25,89,False,2934,Iowa
13,School Totals,200,36,73,.493,30,50,.600,6,23,.261,17,28,.607,14,36,50,21,5,5,5,15,95,False,2935,Iowa
10,School Totals,200,26,55,.473,17,33,.515,9,22,.409,17,24,.708,7,34,41,13,5,3,13,15,78,False,2936,Iowa
13,School Totals,200,28,58,.483,22,38,.579,6,20,.300,7,9,.778,9,31,40,14,4,2,13,17,69,False,2937,Iowa
11,School Totals,200,28,60,.467,23,48,.479,5,12,.417,23,34,.676,10,27,37,17,8,4,10,18,84,False,2938,Iowa
13,School Totals,200,29,51,.569,21,31,.677,8,20,.400,23,35,.657,5,32,37,17,12,4,17,20,89,False,2939,Iowa
13,School Totals,200,25,67,.373,21,50,.420,4,17,.235,13,13,1.000,6,22,28,16,9,1,14,14,67,False,2940,Iowa
11,School Totals,225,33,69,.478,22,50,.440,11,19,.579,9,15,.600,13,28,41,15,6,3,9,13,86,False,1026,Iowa
11,School Totals,250,34,77,.442,25,48,.521,9,29,.310,13,17,.765,12,33,45,11,4,8,19,23,90,False,2941,Iowa
11,School Totals,200,23,53,.434,17,33,.515,6,20,.300,16,23,.696,9,26,35,16,10,9,18,12,68,False,2393,Iowa
12,School Totals,200,34,60,.567,28,46,.609,6,14,.429,9,18,.500,8,26,34,22,5,3,10,18,83,False,2942,Iowa
11,School Totals,200,18,51,.353,14,34,.412,4,17,.235,14,22,.636,7,13,20,12,6,0,14,13,54,False,2943,Iowa
12,School Totals,200,25,70,.357,18,42,.429,7,28,.250,19,25,.760,19,20,39,16,14,4,16,16,76,False,646,Iowa
14,School Totals,200,26,65,.400,21,42,.500,5,23,.217,7,16,.438,15,19,34,14,3,4,13,19,64,False,2674,Iowa
11,School Totals,200,32,64,.500,22,41,.537,10,23,.435,11,20,.550,12,28,40,21,5,5,9,15,85,False,1766,Iowa
13,School Totals,200,30,60,.500,19,42,.452,11,18,.611,12,19,.632,7,21,28,24,15,3,13,19,83,False,2397,Iowa
12,School Totals,200,27,58,.466,18,39,.462,9,19,.474,18,23,.783,10,21,31,22,6,4,11,17,81,False,2944,Iowa
13,School Totals,250,30,75,.400,21,49,.429,9,26,.346,20,28,.714,12,29,41,20,9,6,18,26,89,False,2945,Iowa
12,School Totals,200,21,64,.328,17,43,.395,4,21,.190,20,27,.741,14,16,30,17,12,2,8,18,66,False,1418,Iowa
12,School Totals,200,21,54,.389,14,33,.424,7,21,.333,17,22,.773,10,25,35,11,6,2,15,20,66,False,2678,Iowa
13,School Totals,225,26,56,.464,21,32,.656,5,24,.208,39,47,.830,12,21,33,16,10,6,17,22,96,False,263,Iowa
12,School Totals,200,30,62,.484,14,36,.389,16,26,.615,7,13,.538,11,22,33,17,7,1,12,12,83,False,656,Iowa
12,School Totals,200,22,53,.415,13,34,.382,9,19,.474,6,7,.857,7,25,32,11,9,2,19,18,59,False,2946,Iowa
13,School Totals,200,31,65,.477,19,44,.432,12,21,.571,16,19,.842,14,22,36,24,6,2,11,17,90,False,2074,Iowa
13,School Totals,200,29,65,.446,20,39,.513,9,26,.346,6,10,.600,6,20,26,17,10,3,12,14,73,False,267,Iowa
12,School Totals,200,35,62,.565,25,39,.641,10,23,.435,7,15,.467,12,23,35,21,8,4,14,18,87,False,2947,Iowa
12,School Totals,225,34,62,.548,18,32,.563,16,30,.533,8,19,.421,10,27,37,26,3,4,17,21,92,False,2948,Iowa
14,School Totals,200,31,52,.596,19,30,.633,12,22,.545,21,35,.600,8,28,36,23,8,7,17,19,95,False,2949,Iowa
14,School Totals,200,32,68,.471,21,39,.538,11,29,.379,17,33,.515,21,30,51,25,9,6,9,14,92,False,2950,Iowa
11,School Totals,200,25,46,.543,17,26,.654,8,20,.400,27,36,.750,10,23,33,20,8,6,13,14,85,False,2951,Iowa
11,School Totals,200,22,60,.367,16,41,.390,6,19,.316,21,26,.808,9,23,32,10,6,2,15,19,71,False,2952,Iowa
13,School Totals,200,28,55,.509,20,34,.588,8,21,.381,8,15,.533,7,23,30,16,4,3,15,17,72,False,2953,Iowa
11,School Totals,200,30,50,.600,22,37,.595,8,13,.615,27,35,.771,4,23,27,18,3,4,11,18,95,False,2954,Iowa
12,School Totals,200,22,66,.333,17,46,.370,5,20,.250,6,10,.600,14,29,43,11,5,5,14,19,55,False,2955,Iowa
12,School Totals,200,28,55,.509,24,43,.558,4,12,.333,13,21,.619,13,23,36,16,5,6,18,15,73,False,2084,Iowa
12,School Totals,200,25,65,.385,15,41,.366,10,24,.417,4,9,.444,10,27,37,17,6,6,18,20,64,False,278,Iowa
12,School Totals,200,33,74,.446,22,38,.579,11,36,.306,1,8,.125,20,32,52,23,2,3,17,19,78,False,2956,Iowa
15,School Totals,200,28,63,.444,15,31,.484,13,32,.406,22,28,.786,10,33,43,22,6,8,7,15,91,False,2957,Iowa
16,School Totals,200,37,67,.552,31,49,.633,6,18,.333,10,15,.667,13,26,39,23,10,2,14,14,90,False,2958,Iowa
16,School Totals,200,35,67,.522,29,45,.644,6,22,.273,16,21,.762,10,38,48,25,7,6,12,11,92,False,2959,Iowa
12,School Totals,200,26,53,.491,23,38,.605,3,15,.200,25,36,.694,11,28,39,13,4,5,19,15,80,False,2960,Iowa
15,School Totals,200,36,62,.581,24,36,.667,12,26,.462,14,21,.667,7,22,29,34,7,8,8,8,98,False,2961,Iowa
12,School Totals,200,25,52,.481,19,37,.514,6,15,.400,12,17,.706,6,24,30,16,4,4,13,14,68,False,1062,Iowa
12,School Totals,200,29,68,.426,22,51,.431,7,17,.412,16,23,.696,15,22,37,17,1,5,10,20,81,False,1786,Iowa
11,School Totals,200,28,57,.491,17,36,.472,11,21,.524,6,10,.600,6,19,25,17,2,3,17,18,73,False,678,Iowa
12,School Totals,225,32,64,.500,25,40,.625,7,24,.292,33,40,.825,14,27,41,14,8,4,16,17,104,False,2699,Iowa
13,School Totals,200,24,61,.393,16,42,.381,8,19,.421,8,10,.800,13,19,32,12,3,2,17,17,64,False,2419,Iowa
14,School Totals,200,26,59,.441,20,41,.488,6,18,.333,6,12,.500,12,19,31,18,6,4,10,7,64,False,2962,Iowa
10,School Totals,200,31,60,.517,25,42,.595,6,18,.333,17,22,.773,10,31,41,20,7,3,10,17,85,False,2963,Iowa
11,School Totals,200,33,66,.500,24,45,.533,9,21,.429,9,14,.643,11,17,28,20,6,4,8,22,84,False,2964,Iowa
11,School Totals,200,33,60,.550,21,35,.600,12,25,.480,16,21,.762,8,26,34,22,6,4,7,17,94,False,2965,Iowa
11,School Totals,200,21,55,.382,20,45,.444,1,10,.100,15,22,.682,12,16,28,7,4,1,13,14,58,False,2096,Iowa
12,School Totals,200,36,69,.522,27,49,.551,9,20,.450,12,19,.632,8,19,27,26,6,3,6,22,93,False,1448,Iowa
13,School Totals,200,25,59,.424,19,39,.487,6,20,.300,8,10,.800,9,17,26,12,2,4,12,18,64,False,1794,Iowa
11,School Totals,200,25,52,.481,23,42,.548,2,10,.200,7,9,.778,5,28,33,15,3,3,15,15,59,False,1073,Iowa
12,School Totals,200,27,49,.551,18,28,.643,9,21,.429,19,22,.864,10,21,31,20,6,3,17,15,82,False,297,Iowa
11,School Totals,200,34,69,.493,29,51,.569,5,18,.278,9,17,.529,11,26,37,20,5,3,12,22,82,False,2966,Iowa
13,School Totals,200,25,59,.424,15,30,.500,10,29,.345,17,23,.739,16,24,40,16,6,3,8,13,77,False,2967,Iowa
12,School Totals,200,27,48,.563,19,34,.559,8,14,.571,34,41,.829,10,19,29,17,5,3,17,19,96,False,2705,Iowa
12,School Totals,225,27,65,.415,20,42,.476,7,23,.304,10,18,.556,8,29,37,17,2,1,14,24,71,False,1076,Iowa
12,School Totals,200,21,47,.447,14,22,.636,7,25,.280,28,38,.737,7,30,37,15,3,6,16,15,77,False,2968,Iowa
10,School Totals,200,27,53,.509,22,35,.629,5,18,.278,34,45,.756,6,27,33,16,10,4,17,15,93,False,2969,Iowa
11,School Totals,200,19,52,.365,9,23,.391,10,29,.345,29,33,.879,9,32,41,13,6,3,14,20,77,False,2970,Iowa
10,School Totals,200,29,57,.509,25,44,.568,4,13,.308,29,37,.784,13,21,34,14,5,2,17,15,91,False,2971,Iowa
14,School Totals,200,36,61,.590,27,38,.711,9,23,.391,24,29,.828,4,25,29,20,8,5,8,13,105,False,2972,Iowa
10,School Totals,200,19,52,.365,7,21,.333,12,31,.387,19,28,.679,10,23,33,12,11,4,13,18,69,False,2973,Iowa
10,School Totals,200,23,59,.390,17,35,.486,6,24,.250,14,19,.737,11,27,38,9,2,4,11,16,66,False,2974,Iowa
11,School Totals,200,21,64,.328,15,42,.357,6,22,.273,20,30,.667,14,16,30,13,7,3,10,23,68,False,1465,Iowa
11,School Totals,200,35,61,.574,26,43,.605,9,18,.500,19,23,.826,17,27,44,21,3,2,18,21,98,False,2975,Iowa
14,School Totals,200,29,54,.537,19,29,.655,10,25,.400,9,14,.643,6,30,36,18,6,1,12,14,77,False,2976,Iowa
13,School Totals,200,23,49,.469,18,31,.581,5,18,.278,27,37,.730,6,17,23,15,10,8,10,13,78,False,2977,Iowa
12,School Totals,200,39,70,.557,20,28,.714,19,42,.452,13,22,.591,8,34,42,30,8,2,6,10,110,False,2978,Iowa
9,School Totals,200,21,46,.457,12,21,.571,9,25,.360,21,31,.677,9,22,31,16,6,7,9,13,72,False,2979,Iowa
10,School Totals,200,24,50,.480,18,33,.545,6,17,.353,16,19,.842,7,16,23,15,3,4,14,15,70,False,2980,Iowa
11,School Totals,200,27,59,.458,17,37,.459,10,22,.455,29,32,.906,11,27,38,16,6,6,13,22,93,False,2981,Iowa
9,School Totals,200,24,58,.414,20,41,.488,4,17,.235,21,26,.808,9,27,36,14,6,0,7,15,73,False,2982,Iowa
10,School Totals,200,25,55,.455,21,39,.538,4,16,.250,18,25,.720,9,25,34,15,11,6,14,15,72,False,1814,Iowa
10,School Totals,200,32,64,.500,20,36,.556,12,28,.429,13,18,.722,7,27,34,18,9,1,11,11,89,False,2120,Iowa
13,School Totals,200,34,50,.680,19,29,.655,15,21,.714,12,16,.750,1,25,26,29,3,5,14,11,95,False,2720,Iowa
11,School Totals,200,27,70,.386,22,46,.478,5,24,.208,8,8,1.000,10,13,23,13,9,0,5,16,67,False,1475,Iowa
11,School Totals,200,32,59,.542,22,41,.537,10,18,.556,13,21,.619,9,22,31,23,7,1,13,23,87,False,2983,Iowa
10,School Totals,200,26,57,.456,20,43,.465,6,14,.429,16,24,.667,7,38,45,10,7,5,9,14,74,False,1105,Iowa
10,School Totals,200,27,60,.450,17,35,.486,10,25,.400,13,17,.765,9,18,27,14,8,2,9,18,77,False,323,Iowa
10,School Totals,200,26,55,.473,17,38,.447,9,17,.529,19,25,.760,5,18,23,13,6,0,11,15,80,False,2984,Iowa
10,School Totals,200,25,54,.463,17,33,.515,8,21,.381,13,18,.722,10,19,29,12,6,5,15,15,71,False,2445,Iowa
10,School Totals,200,19,58,.328,11,32,.344,8,26,.308,19,24,.792,15,20,35,12,6,3,14,12,65,False,717,Iowa
10,School Totals,225,26,62,.419,19,37,.514,7,25,.280,17,25,.680,12,31,43,18,4,4,10,18,76,False,327,Iowa
13,School Totals,200,26,55,.473,20,36,.556,6,19,.316,12,14,.857,4,21,25,10,4,1,10,18,70,False,1821,Iowa
11,School Totals,200,20,56,.357,12,27,.444,8,29,.276,24,36,.667,13,23,36,12,3,2,13,21,72,False,2447,Iowa
12,School Totals,200,18,59,.305,13,37,.351,5,22,.227,4,6,.667,7,22,29,10,9,4,15,25,45,False,2985,Iowa
10,School Totals,225,30,69,.435,20,43,.465,10,26,.385,21,32,.656,13,28,41,18,5,2,13,21,91,False,2986,Iowa
14,School Totals,200,31,60,.517,19,37,.514,12,23,.522,9,11,.818,9,14,23,25,3,2,7,9,83,False,2728,Iowa
14,School Totals,200,21,59,.356,20,43,.465,1,16,.063,10,18,.556,9,26,35,10,4,4,11,9,53,False,1113,Iowa
10,School Totals,200,29,53,.547,18,31,.581,11,22,.500,10,16,.625,4,24,28,15,1,1,14,15,79,False,2987,Iowa
10,School Totals,225,23,59,.390,16,38,.421,7,21,.333,24,32,.750,10,21,31,8,6,3,11,21,77,False,2988,Iowa
14,School Totals,200,26,56,.464,18,31,.581,8,25,.320,27,32,.844,7,24,31,17,9,4,12,8,87,False,2989,Iowa
13,School Totals,200,24,56,.429,18,38,.474,6,18,.333,24,32,.750,7,19,26,12,10,2,19,16,78,False,2990,Iowa
11,School Totals,200,32,68,.471,24,44,.545,8,24,.333,15,26,.577,15,25,40,21,5,3,8,17,87,False,2991,Iowa
13,School Totals,200,32,72,.444,26,50,.520,6,22,.273,13,20,.650,19,25,44,22,3,7,6,10,83,False,2992,Iowa
14,School Totals,200,30,57,.526,23,41,.561,7,16,.438,18,29,.621,11,28,39,21,8,6,11,9,85,False,2993,Iowa
10,School Totals,200,23,56,.411,12,29,.414,11,27,.407,15,19,.789,4,30,34,20,8,3,14,21,72,False,2994,Iowa
10,School Totals,200,23,57,.404,14,34,.412,9,23,.391,18,20,.900,11,16,27,16,8,0,13,20,73,False,2995,Iowa
9,School Totals,200,26,61,.426,15,27,.556,11,34,.324,5,8,.625,11,24,35,17,10,1,10,15,68,False,2996,Iowa
10,School Totals,200,35,74,.473,32,59,.542,3,15,.200,18,24,.750,14,14,28,13,1,0,7,22,91,False,1127,Iowa
11,School Totals,200,26,61,.426,16,40,.400,10,21,.476,10,14,.714,10,26,36,20,6,3,8,13,72,False,2997,Iowa
10,School Totals,200,28,65,.431,18,37,.486,10,28,.357,18,20,.900,14,26,40,13,8,1,11,11,84,False,2998,Iowa
9,School Totals,200,23,50,.460,12,26,.462,11,24,.458,20,30,.667,9,35,44,16,3,7,24,17,77,False,2999,Iowa
12,School Totals,200,39,65,.600,33,49,.673,6,16,.375,9,18,.500,8,23,31,27,14,8,6,14,93,False,3000,Iowa
9,School Totals,200,31,65,.477,20,39,.513,11,26,.423,13,20,.650,12,26,38,16,4,5,15,16,86,False,2143,Iowa
9,School Totals,200,32,77,.416,28,44,.636,4,33,.121,2,5,.400,16,27,43,17,6,3,11,20,70,False,3001,Iowa
9,School Totals,200,23,61,.377,14,38,.368,9,23,.391,12,14,.857,13,28,41,16,10,5,17,15,67,False,739,Iowa
9,School Totals,200,26,55,.473,16,33,.485,10,22,.455,13,15,.867,5,25,30,24,5,5,7,16,75,False,3002,Iowa
9,School Totals,200,27,53,.509,18,37,.486,9,16,.563,27,30,.900,8,26,34,22,2,2,14,13,90,False,1135,Iowa
9,School Totals,200,29,55,.527,20,30,.667,9,25,.360,18,25,.720,10,26,36,19,3,5,13,16,85,False,2464,Iowa
9,School Totals,200,20,60,.333,17,40,.425,3,20,.150,25,32,.781,11,31,42,10,2,7,9,15,68,False,3003,Iowa
11,School Totals,200,25,69,.362,17,45,.378,8,24,.333,14,17,.824,12,21,33,15,7,4,8,22,72,False,743,Iowa
10,School Totals,200,25,50,.500,15,27,.556,10,23,.435,12,17,.706,8,22,30,19,7,3,13,15,72,False,2745,Iowa
13,School Totals,200,23,54,.426,17,29,.586,6,25,.240,16,21,.762,7,12,19,13,7,1,14,14,68,False,3004,Iowa
13,School Totals,200,35,72,.486,24,44,.545,11,28,.393,15,17,.882,9,28,37,20,11,2,8,17,96,False,3005,Iowa
10,School Totals,200,26,52,.500,22,38,.579,4,14,.286,21,27,.778,6,20,26,9,7,5,18,21,77,False,359,Iowa
9,School Totals,200,23,56,.411,19,43,.442,4,13,.308,8,14,.571,8,26,34,14,5,6,10,16,58,False,3006,Iowa
8,School Totals,200,29,52,.558,19,27,.704,10,25,.400,17,25,.680,5,21,26,18,6,2,9,16,85,False,1848,Iowa
10,School Totals,200,26,65,.400,20,38,.526,6,27,.222,12,18,.667,15,22,37,14,5,3,12,21,70,False,1513,Iowa
9,School Totals,200,28,66,.424,21,49,.429,7,17,.412,14,17,.824,11,28,39,22,4,7,9,12,77,False,2153,Iowa
10,School Totals,200,21,56,.375,13,26,.500,8,30,.267,18,22,.818,8,22,30,17,7,8,15,20,68,False,3007,Iowa
12,School Totals,200,26,52,.500,17,33,.515,9,19,.474,15,15,1.000,5,25,30,18,0,2,11,18,76,False,2748,Iowa
15,School Totals,200,32,66,.485,22,36,.611,10,30,.333,23,29,.793,20,24,44,20,9,7,9,16,97,False,3008,Iowa
11,School Totals,200,34,61,.557,22,37,.595,12,24,.500,23,31,.742,9,25,34,28,4,6,9,17,103,False,3009,Iowa
16,School Totals,200,33,70,.471,25,47,.532,8,23,.348,25,33,.758,11,42,53,25,4,7,11,17,99,False,3010,Iowa
10,School Totals,200,34,76,.447,17,36,.472,17,40,.425,8,14,.571,13,21,34,22,8,5,10,17,93,False,3011,Iowa
15,School Totals,200,37,68,.544,26,39,.667,11,29,.379,20,24,.833,14,24,38,20,6,3,7,12,105,False,3012,Iowa
17,School Totals,200,41,73,.562,29,43,.674,12,30,.400,12,18,.667,15,29,44,29,12,7,8,9,106,False,3013,Iowa
10,School Totals,200,35,75,.467,31,53,.585,4,22,.182,14,26,.538,12,23,35,16,7,5,12,20,88,False,3014,Iowa
10,School Totals,200,24,56,.429,12,22,.545,12,34,.353,10,14,.714,9,25,34,21,6,4,11,10,70,False,3015,Iowa
11,School Totals,225,29,78,.372,19,48,.396,10,30,.333,27,38,.711,21,26,47,17,6,1,7,22,95,False,3016,Iowa
10,School Totals,200,28,58,.483,17,32,.531,11,26,.423,20,25,.800,7,25,32,17,6,2,9,12,87,False,3017,Iowa
12,School Totals,200,26,56,.464,19,38,.500,7,18,.389,18,23,.783,9,28,37,13,8,9,15,13,77,False,2477,Iowa
13,School Totals,200,36,67,.537,23,41,.561,13,26,.500,4,6,.667,6,31,37,22,9,2,11,10,89,False,764,Iowa
11,School Totals,200,31,56,.554,22,42,.524,9,14,.643,15,21,.714,4,35,39,27,3,2,10,15,86,False,3018,Iowa
15,School Totals,200,33,57,.579,23,33,.697,10,24,.417,20,26,.769,6,31,37,22,2,6,9,14,96,False,3019,Iowa
13,School Totals,200,24,63,.381,19,40,.475,5,23,.217,16,21,.762,16,29,45,14,5,3,10,25,69,False,382,Iowa
10,School Totals,200,31,72,.431,21,47,.447,10,25,.400,3,6,.500,11,19,30,17,4,4,8,15,75,False,2758,Iowa
12,School Totals,200,28,56,.500,23,39,.590,5,17,.294,23,35,.657,13,25,38,16,3,5,4,17,84,False,1530,Iowa
11,School Totals,200,30,68,.441,16,36,.444,14,32,.438,11,17,.647,11,24,35,20,4,0,6,13,85,False,1868,Iowa
12,School Totals,200,19,51,.373,11,30,.367,8,21,.381,19,22,.864,6,30,36,5,5,5,10,20,65,False,385,Iowa
13,School Totals,200,26,60,.433,15,37,.405,11,23,.478,16,20,.800,12,26,38,20,6,5,9,13,79,False,2481,Iowa
15,School Totals,200,32,65,.492,19,40,.475,13,25,.520,11,19,.579,9,35,44,24,4,5,4,18,88,False,1533,Iowa
10,School Totals,200,26,51,.510,14,32,.438,12,19,.632,13,19,.684,6,34,40,16,2,4,11,13,77,False,3020,Iowa
11,School Totals,200,26,58,.448,16,33,.485,10,25,.400,12,22,.545,9,32,41,19,5,3,15,15,74,False,2167,Iowa
13,School Totals,200,21,59,.356,15,40,.375,6,19,.316,9,11,.818,6,25,31,4,4,3,9,12,57,False,1163,Iowa
9,School Totals,200,29,62,.468,19,38,.500,10,24,.417,5,9,.556,5,26,31,22,5,1,5,13,73,False,1870,Iowa
15,School Totals,200,38,74,.514,22,31,.710,16,43,.372,10,16,.625,8,36,44,25,12,7,8,10,102,False,3021,Iowa
10,School Totals,200,28,55,.509,21,32,.656,7,23,.304,14,20,.700,8,26,34,17,2,7,9,12,77,False,3022,Iowa
10,School Totals,200,26,64,.406,24,44,.545,2,20,.100,8,10,.800,12,23,35,18,6,10,8,15,62,False,3023,Iowa
11,School Totals,200,26,64,.406,18,40,.450,8,24,.333,11,14,.786,6,28,34,19,5,3,12,18,71,False,2765,Iowa
10,School Totals,200,29,54,.537,19,32,.594,10,22,.455,18,24,.750,9,23,32,17,4,6,6,15,86,False,3024,Iowa
15,School Totals,200,31,68,.456,23,43,.535,8,25,.320,10,14,.714,9,20,29,22,7,4,11,13,80,False,3025,Iowa
11,School Totals,200,34,63,.540,25,38,.658,9,25,.360,10,20,.500,14,21,35,25,15,15,15,19,87,False,3026,Minnesota
11,School Totals,200,29,53,.547,18,34,.529,11,19,.579,13,14,.929,6,27,33,21,13,8,15,11,82,False,3027,Minnesota
10,School Totals,200,27,63,.429,22,44,.500,5,19,.263,17,23,.739,11,16,27,21,15,5,5,13,76,False,3028,Minnesota
11,School Totals,200,25,50,.500,16,31,.516,9,19,.474,23,36,.639,7,24,31,12,9,6,17,30,82,False,3029,Minnesota
11,School Totals,200,20,60,.333,17,41,.415,3,19,.158,13,22,.591,10,18,28,7,8,3,10,17,56,False,3030,Minnesota
11,School Totals,200,22,57,.386,19,48,.396,3,9,.333,18,27,.667,10,24,34,12,5,2,16,26,65,False,3031,Minnesota
10,School Totals,200,22,51,.431,15,32,.469,7,19,.368,7,15,.467,6,17,23,12,7,4,11,16,58,False,3032,Minnesota
12,School Totals,200,36,67,.537,26,44,.591,10,23,.435,9,13,.692,12,28,40,25,9,10,7,14,91,False,3033,Minnesota
12,School Totals,200,28,57,.491,23,44,.523,5,13,.385,33,46,.717,14,27,41,18,10,9,17,19,94,False,3034,Minnesota
12,School Totals,200,39,73,.534,30,53,.566,9,20,.450,10,15,.667,13,27,40,24,11,7,12,17,97,False,3035,Minnesota
11,School Totals,200,34,61,.557,23,41,.561,11,20,.550,10,12,.833,9,26,35,24,11,7,14,14,89,False,3036,Minnesota
12,School Totals,200,37,68,.544,30,48,.625,7,20,.350,11,13,.846,10,26,36,25,16,9,12,13,92,False,3037,Minnesota
11,School Totals,200,28,57,.491,20,35,.571,8,22,.364,11,18,.611,10,17,27,12,11,5,7,12,75,False,1888,Minnesota
11,School Totals,200,35,70,.500,27,49,.551,8,21,.381,8,13,.615,12,23,35,23,17,4,16,16,86,False,2781,Minnesota
11,School Totals,200,20,65,.308,16,46,.348,4,19,.211,16,25,.640,15,20,35,8,11,3,13,24,60,False,3038,Minnesota
11,School Totals,200,20,44,.455,9,21,.429,11,23,.478,22,30,.733,9,20,29,18,11,5,17,17,73,False,1551,Minnesota
12,School Totals,200,22,54,.407,18,42,.429,4,12,.333,5,7,.714,10,22,32,12,4,6,14,21,53,False,1188,Minnesota
12,School Totals,225,27,55,.491,21,41,.512,6,14,.429,18,29,.621,10,19,29,16,6,7,11,30,78,False,16,Minnesota
11,School Totals,200,27,56,.482,22,43,.512,5,13,.385,5,7,.714,6,23,29,19,5,7,10,8,64,False,1191,Minnesota
11,School Totals,200,24,50,.480,15,33,.455,9,17,.529,8,10,.800,6,25,31,20,7,11,14,12,65,False,3039,Minnesota
12,School Totals,200,25,49,.510,21,38,.553,4,11,.364,9,14,.643,6,16,22,15,4,0,17,10,63,False,1557,Minnesota
11,School Totals,200,21,45,.467,16,29,.552,5,16,.313,19,25,.760,4,27,31,15,6,5,12,15,66,False,1895,Minnesota
12,School Totals,200,20,44,.455,13,27,.481,7,17,.412,16,23,.696,11,21,32,14,3,5,15,19,63,False,805,Minnesota
10,School Totals,225,26,62,.419,14,35,.400,12,27,.444,10,12,.833,15,22,37,19,4,3,15,21,74,False,3040,Minnesota
9,School Totals,200,20,42,.476,15,33,.455,5,9,.556,23,28,.821,11,27,38,11,4,5,11,11,68,False,3041,Minnesota
12,School Totals,200,31,56,.554,22,36,.611,9,20,.450,10,14,.714,8,29,37,23,6,7,11,15,81,False,25,Minnesota
11,School Totals,200,20,48,.417,16,38,.421,4,10,.400,14,19,.737,6,20,26,15,2,2,8,13,58,False,3042,Minnesota
10,School Totals,200,20,48,.417,14,33,.424,6,15,.400,16,21,.762,5,28,33,11,2,0,10,12,62,False,2508,Minnesota
12,School Totals,200,25,55,.455,22,39,.564,3,16,.188,2,4,.500,10,14,24,16,3,4,14,14,55,False,810,Minnesota
12,School Totals,200,31,53,.585,19,34,.559,12,19,.632,14,15,.933,8,21,29,24,9,7,8,13,88,False,2787,Minnesota
12,School Totals,200,29,50,.580,20,31,.645,9,19,.474,9,14,.643,5,17,22,14,8,3,8,16,76,False,1899,Minnesota
11,School Totals,225,23,59,.390,13,36,.361,10,23,.435,16,21,.762,13,21,34,13,6,4,14,22,72,False,1200,Minnesota
12,School Totals,200,24,50,.480,22,43,.512,2,7,.286,19,26,.731,10,35,45,12,5,5,16,14,69,False,3043,Minnesota
12,School Totals,200,19,62,.306,12,36,.333,7,26,.269,9,14,.643,13,24,37,14,2,11,8,18,54,False,3044,Minnesota
11,School Totals,200,25,56,.446,22,41,.537,3,15,.200,16,25,.640,13,28,41,17,10,6,13,18,69,False,3045,Minnesota
11,School Totals,200,25,57,.439,18,35,.514,7,22,.318,19,30,.633,14,19,33,17,15,6,15,14,76,False,3046,Minnesota
11,School Totals,200,35,56,.625,27,41,.659,8,15,.533,17,31,.548,9,28,37,19,4,10,19,17,95,False,3047,Minnesota
11,School Totals,200,23,55,.418,16,30,.533,7,25,.280,19,31,.613,12,32,44,13,8,1,18,21,72,False,3048,Minnesota
11,School Totals,200,22,50,.440,18,33,.545,4,17,.235,26,35,.743,17,19,36,10,6,4,13,25,74,False,3049,Minnesota
12,School Totals,200,27,60,.450,18,41,.439,9,19,.474,21,32,.656,16,28,44,23,7,12,14,13,84,False,3050,Minnesota
11,School Totals,200,29,58,.500,20,36,.556,9,22,.409,12,20,.600,9,21,30,15,7,7,11,22,79,False,3051,Minnesota
11,School Totals,200,20,49,.408,15,33,.455,5,16,.313,26,44,.591,16,29,45,15,10,6,13,13,71,False,3052,Minnesota
11,School Totals,200,31,64,.484,23,47,.489,8,17,.471,13,17,.765,12,28,40,19,10,4,15,15,83,False,3053,Minnesota
11,School Totals,200,26,50,.520,19,30,.633,7,20,.350,12,22,.545,10,24,34,20,11,1,16,13,71,False,3054,Minnesota
11,School Totals,200,25,60,.417,21,44,.477,4,16,.250,12,22,.545,15,30,45,18,12,8,17,10,66,False,3055,Minnesota
11,School Totals,200,32,61,.525,27,46,.587,5,15,.333,16,26,.615,14,20,34,19,6,5,12,14,85,False,3056,Minnesota
11,School Totals,200,23,59,.390,20,47,.426,3,12,.250,11,15,.733,13,24,37,16,1,2,8,18,60,False,3057,Minnesota
10,School Totals,200,24,58,.414,20,44,.455,4,14,.286,10,13,.769,10,19,29,9,3,4,14,18,62,False,1217,Minnesota
11,School Totals,200,22,53,.415,17,39,.436,5,14,.357,18,28,.643,15,24,39,11,5,10,11,13,67,False,46,Minnesota
10,School Totals,200,19,45,.422,17,31,.548,2,14,.143,24,27,.889,8,24,32,13,8,6,15,22,64,False,1583,Minnesota
10,School Totals,200,27,51,.529,21,37,.568,6,14,.429,10,16,.625,6,18,24,19,6,9,8,13,70,False,3058,Minnesota
10,School Totals,200,20,46,.435,18,36,.500,2,10,.200,27,37,.730,13,25,38,17,9,12,10,13,69,False,2802,Minnesota
10,School Totals,200,26,41,.634,22,33,.667,4,8,.500,13,23,.565,11,26,37,16,4,3,17,11,69,False,832,Minnesota
9,School Totals,200,24,45,.533,22,34,.647,2,11,.182,31,46,.674,7,24,31,18,5,5,12,13,81,False,3059,Minnesota
10,School Totals,200,23,52,.442,20,43,.465,3,9,.333,12,19,.632,9,21,30,15,7,4,11,19,61,False,3060,Minnesota
9,School Totals,200,20,54,.370,14,36,.389,6,18,.333,11,22,.500,15,19,34,9,4,5,10,13,57,False,53,Minnesota
10,School Totals,200,25,49,.510,20,36,.556,5,13,.385,14,18,.778,6,23,29,16,5,6,19,23,69,False,1589,Minnesota
10,School Totals,200,24,66,.364,20,51,.392,4,15,.267,10,17,.588,15,25,40,14,7,7,16,18,62,False,2531,Minnesota
9,School Totals,200,22,47,.468,20,36,.556,2,11,.182,16,21,.762,10,20,30,16,11,1,14,13,62,False,2804,Minnesota
9,School Totals,200,24,51,.471,15,30,.500,9,21,.429,6,10,.600,8,23,31,19,0,1,13,18,63,False,1917,Minnesota
10,School Totals,200,18,48,.375,15,40,.375,3,8,.375,9,15,.600,7,25,32,13,9,5,15,15,48,False,1229,Minnesota
10,School Totals,200,25,58,.431,19,42,.452,6,16,.375,7,8,.875,10,24,34,22,4,7,9,11,63,False,841,Minnesota
10,School Totals,200,23,52,.442,20,35,.571,3,17,.176,8,11,.727,8,24,32,12,8,3,12,22,57,False,3061,Minnesota
10,School Totals,200,23,53,.434,21,38,.553,2,15,.133,15,19,.789,8,17,25,14,5,4,11,16,63,False,1920,Minnesota
10,School Totals,200,21,56,.375,16,41,.390,5,15,.333,18,26,.692,12,28,40,13,4,5,8,20,65,False,3062,Minnesota
13,School Totals,200,22,55,.400,19,40,.475,3,15,.200,23,35,.657,11,24,35,13,7,6,10,21,70,False,3063,Minnesota
15,School Totals,200,27,47,.574,21,33,.636,6,14,.429,11,21,.524,5,25,30,19,14,9,15,21,71,False,3064,Minnesota
13,School Totals,200,19,41,.463,17,33,.515,2,8,.250,27,31,.871,8,19,27,9,10,4,23,19,67,False,3065,Minnesota
14,School Totals,200,30,60,.500,25,45,.556,5,15,.333,20,31,.645,16,16,32,21,12,5,8,18,85,False,3066,Minnesota
13,School Totals,200,34,66,.515,33,57,.579,1,9,.111,17,27,.630,19,18,37,13,9,4,17,16,86,False,3067,Minnesota
13,School Totals,200,27,53,.509,19,38,.500,8,15,.533,14,19,.737,9,24,33,16,7,4,15,18,76,False,3068,Minnesota
15,School Totals,200,21,48,.438,14,30,.467,7,18,.389,21,27,.778,6,18,24,11,7,7,21,17,70,False,3069,Minnesota
11,School Totals,200,24,48,.500,22,35,.629,2,13,.154,8,15,.533,10,18,28,17,9,5,9,12,58,False,3070,Minnesota
11,School Totals,200,20,41,.488,14,28,.500,6,13,.462,9,9,1.000,5,21,26,16,8,6,18,16,55,False,3071,Minnesota
11,School Totals,200,27,50,.540,25,44,.568,2,6,.333,14,19,.737,10,22,32,18,8,6,9,15,70,False,3072,Minnesota
13,School Totals,200,24,52,.462,20,40,.500,4,12,.333,17,27,.630,11,20,31,19,9,6,10,14,69,False,3073,Minnesota
13,School Totals,200,27,47,0.574,19,30,0.633,8,17,0.471,14,18,0.778,7,26,33,24,7,8,18,15,76,False,3074,Minnesota
12,School Totals,200,21,46,.457,15,32,.469,6,14,.429,15,24,.625,7,20,27,12,12,8,12,13,63,False,3075,Minnesota
12,School Totals,250,26,69,.377,22,55,.400,4,14,.286,16,18,.889,10,23,33,15,8,4,14,19,72,False,2549,Minnesota
11,School Totals,200,21,49,.429,13,30,.433,8,19,.421,6,8,.750,6,20,26,16,5,3,12,18,56,False,860,Minnesota
11,School Totals,200,26,58,.448,22,35,.629,4,23,.174,6,10,.600,11,19,30,16,9,5,12,20,62,False,2822,Minnesota
12,School Totals,200,24,58,.414,19,48,.396,5,10,.500,13,19,.684,11,21,32,16,8,7,13,20,66,False,3076,Minnesota
11,School Totals,200,29,62,.468,23,45,.511,6,17,.353,13,18,.722,16,17,33,16,8,8,11,25,77,False,79,Minnesota
11,School Totals,200,21,38,.553,16,28,.571,5,10,.500,33,44,.750,3,26,29,13,3,7,17,23,80,False,1939,Minnesota
14,School Totals,200,30,52,.577,27,40,.675,3,12,.250,12,17,.706,4,30,34,19,10,5,12,20,75,False,3077,Minnesota
14,School Totals,200,18,47,.383,12,31,.387,6,16,.375,10,14,.714,7,17,24,11,4,1,12,19,52,False,1254,Minnesota
11,School Totals,225,25,54,.463,19,36,.528,6,18,.333,21,33,.636,9,25,34,18,10,2,14,24,77,False,2554,Minnesota
11,School Totals,200,20,51,.392,10,32,.313,10,19,.526,9,14,.643,9,25,34,17,1,6,15,18,59,False,2825,Minnesota
12,School Totals,200,27,50,.540,20,33,.606,7,17,.412,8,16,.500,10,19,29,18,6,3,14,16,69,False,3078,Minnesota
11,School Totals,225,23,55,.418,17,38,.447,6,17,.353,9,14,.643,8,24,32,10,3,4,13,21,61,False,3079,Minnesota
12,School Totals,200,24,52,.462,19,32,.594,5,20,.250,15,23,.652,8,20,28,16,4,3,14,21,68,False,1621,Minnesota
12,School Totals,200,21,50,.420,16,33,.485,5,17,.294,6,13,.462,12,24,36,14,6,3,18,19,53,False,3080,Minnesota
11,School Totals,200,21,46,.457,16,33,.485,5,13,.385,14,15,.933,7,24,31,13,4,4,14,20,61,False,1260,Minnesota
12,School Totals,200,18,58,.310,11,41,.268,7,17,.412,7,14,.500,11,19,30,11,8,2,16,20,50,False,91,Minnesota
11,School Totals,200,11,46,.239,9,35,.257,2,11,.182,21,29,.724,13,22,35,3,2,5,10,24,45,False,3081,Minnesota
12,School Totals,200,26,48,.542,16,26,.615,10,22,.455,19,24,.792,4,24,28,23,8,7,12,10,81,False,3082,Minnesota
11,School Totals,225,29,62,.468,18,36,.500,11,26,.423,6,10,.600,13,28,41,15,6,4,14,18,75,False,3083,Minnesota
10,School Totals,225,24,53,.453,15,30,.500,9,23,.391,12,15,.800,11,20,31,17,4,4,16,21,69,False,876,Minnesota
11,School Totals,200,28,54,.519,27,43,.628,1,11,.091,13,18,.722,9,21,30,15,9,3,15,14,70,False,3084,Minnesota
13,School Totals,200,28,48,.583,22,35,.629,6,13,.462,16,19,.842,10,27,37,14,2,2,18,21,78,False,3085,Minnesota
10,School Totals,200,27,55,.491,21,44,.477,6,11,.545,18,24,.750,11,18,29,11,10,5,14,20,78,False,3086,Minnesota
10,School Totals,225,26,59,.441,23,46,.500,3,13,.231,13,20,.650,8,26,34,15,5,7,19,17,68,False,3087,Minnesota
11,School Totals,200,19,51,.373,16,38,.421,3,13,.231,10,17,.588,9,20,29,13,7,4,22,20,51,False,3088,Minnesota
14,School Totals,200,27,62,.435,23,40,.575,4,22,.182,14,21,.667,19,18,37,17,15,10,7,20,72,False,3089,Minnesota
14,School Totals,200,28,57,.491,23,43,.535,5,14,.357,21,30,.700,16,27,43,18,12,9,19,24,82,False,3090,Minnesota
13,School Totals,200,26,54,.481,20,38,.526,6,16,.375,14,23,.609,8,30,38,22,13,7,17,20,72,False,3091,Minnesota
12,School Totals,200,26,46,.565,21,36,.583,5,10,.500,15,21,.714,9,28,37,17,5,9,19,13,72,False,3092,Minnesota
12,School Totals,200,24,60,.400,20,44,.455,4,16,.250,19,25,.760,16,18,34,15,7,6,15,19,71,False,3093,Minnesota
12,School Totals,200,25,49,.510,19,35,.543,6,14,.429,28,33,.848,10,22,32,16,10,5,17,22,84,False,3094,Minnesota
12,School Totals,200,19,43,.442,17,34,.500,2,9,.222,26,35,.743,12,20,32,7,5,5,17,16,66,False,3095,Minnesota
12,School Totals,200,26,55,.473,21,41,.512,5,14,.357,20,28,.714,16,16,32,17,3,6,12,19,77,False,3096,Minnesota
13,School Totals,200,33,73,.452,32,60,.533,1,13,.077,20,26,.769,21,21,42,18,15,13,13,13,87,False,3097,Minnesota
13,School Totals,200,33,58,.569,23,36,.639,10,22,.455,12,20,.600,11,23,34,21,13,6,13,14,88,False,3098,Minnesota
11,School Totals,200,23,55,.418,17,36,.472,6,19,.316,19,27,.704,10,26,36,16,10,3,13,18,71,False,3099,Minnesota
15,School Totals,200,23,60,.383,16,42,.381,7,18,.389,17,22,.773,16,22,38,14,11,4,10,15,70,False,3100,Minnesota
14,School Totals,200,28,67,.418,23,49,.469,5,18,.278,14,25,.560,21,19,40,17,13,2,9,6,75,False,3101,Minnesota
12,School Totals,200,30,53,.566,27,45,.600,3,8,.375,13,22,.591,13,25,38,19,9,8,16,12,76,False,1282,Minnesota
13,School Totals,200,23,48,.479,17,35,.486,6,13,.462,17,28,.607,20,25,45,14,8,7,15,15,69,False,3102,Minnesota
12,School Totals,200,27,51,.529,18,36,.500,9,15,.600,21,27,.778,7,27,34,17,5,3,15,19,84,False,2576,Minnesota
11,School Totals,200,29,66,.439,18,39,.462,11,27,.407,12,15,.800,11,16,27,15,9,6,17,25,81,False,114,Minnesota
11,School Totals,200,25,52,.481,17,36,.472,8,16,.500,17,27,.630,12,18,30,16,10,6,15,21,75,False,896,Minnesota
13,School Totals,200,18,54,.333,13,35,.371,5,19,.263,7,17,.412,17,25,42,11,4,8,15,23,48,False,3103,Minnesota
11,School Totals,200,16,46,.348,11,35,.314,5,11,.455,7,12,.583,7,21,28,6,5,3,9,18,44,False,3104,Minnesota
15,School Totals,200,32,59,.542,28,47,.596,4,12,.333,16,23,.696,15,19,34,24,10,3,6,13,84,False,3105,Minnesota
12,School Totals,200,22,49,.449,18,33,.545,4,16,.250,14,21,.667,11,22,33,17,7,7,12,15,62,False,2848,Minnesota
13,School Totals,200,18,49,.367,13,32,.406,5,17,.294,9,15,.600,11,25,36,8,2,3,12,17,50,False,1290,Minnesota
11,School Totals,200,19,50,.380,14,33,.424,5,17,.294,10,13,.769,10,24,34,10,5,6,12,16,53,False,2581,Minnesota
12,School Totals,225,18,49,.367,14,32,.438,4,17,.235,18,24,.750,6,23,29,9,7,5,8,16,58,False,3106,Minnesota
12,School Totals,200,17,47,.362,14,33,.424,3,14,.214,14,23,.609,12,17,29,11,7,5,17,19,51,False,2851,Minnesota
13,School Totals,200,14,48,.292,12,33,.364,2,15,.133,15,20,.750,11,24,35,7,3,2,21,21,45,False,1652,Minnesota
10,School Totals,200,27,63,.429,23,43,.535,4,20,.200,19,27,.704,17,21,38,17,6,4,10,19,77,False,126,Minnesota
15,School Totals,200,27,54,.500,22,37,.595,5,17,.294,14,24,.583,10,31,41,20,6,5,10,23,73,False,1969,Minnesota
10,School Totals,200,19,50,.380,16,37,.432,3,13,.231,10,20,.500,11,19,30,7,1,9,8,18,51,False,3107,Minnesota
12,School Totals,200,26,60,.433,17,37,.459,9,23,.391,12,15,.800,11,19,30,17,4,5,13,19,73,False,3108,Minnesota
12,School Totals,200,16,40,.400,10,23,.435,6,17,.353,11,14,.786,9,27,36,13,2,3,17,13,49,False,2586,Minnesota
12,School Totals,200,31,61,.508,22,45,.489,9,16,.563,12,19,.632,10,25,35,19,7,3,11,19,83,False,3109,Minnesota
12,School Totals,200,20,50,.400,12,32,.375,8,18,.444,16,22,.727,11,16,27,11,4,1,13,25,64,False,3110,Minnesota
12,School Totals,200,27,59,.458,18,34,.529,9,25,.360,18,21,.857,10,25,35,19,11,4,12,15,81,False,3111,Minnesota
13,School Totals,200,27,61,.443,16,36,.444,11,25,.440,19,28,.679,11,29,40,14,9,7,7,21,84,False,3112,Minnesota
10,School Totals,200,25,67,.373,18,42,.429,7,25,.280,17,28,.607,16,34,50,9,5,0,8,20,74,False,3113,Minnesota
10,School Totals,200,27,62,.435,19,34,.559,8,28,.286,20,24,.833,10,21,31,15,11,4,9,16,82,False,3114,Minnesota
12,School Totals,200,30,59,.508,22,36,.611,8,23,.348,11,13,.846,10,24,34,20,8,12,8,20,79,False,3115,Minnesota
8,School Totals,200,23,52,.442,14,30,.467,9,22,.409,12,13,.923,12,20,32,16,6,6,19,18,67,False,3116,Minnesota
10,School Totals,200,25,55,.455,18,35,.514,7,20,.350,16,21,.762,8,17,25,10,6,1,16,20,73,False,3117,Minnesota
14,School Totals,200,26,68,.382,20,44,.455,6,24,.250,25,29,.862,12,22,34,12,11,4,7,18,83,False,3118,Minnesota
12,School Totals,200,18,53,.340,11,37,.297,7,16,.438,28,38,.737,9,16,25,12,8,5,6,25,71,False,3119,Minnesota
10,School Totals,200,25,51,.490,17,31,.548,8,20,.400,22,27,.815,11,20,31,15,13,8,16,17,80,False,3120,Minnesota
11,School Totals,200,27,62,.435,19,36,.528,8,26,.308,13,15,.867,13,25,38,21,7,2,7,15,75,False,3121,Minnesota
12,School Totals,200,31,60,.517,22,37,.595,9,23,.391,21,29,.724,9,27,36,14,10,3,9,16,92,False,3122,Minnesota
12,School Totals,200,22,59,.373,13,33,.394,9,26,.346,12,22,.545,10,24,34,17,9,6,12,19,65,False,3123,Minnesota
9,School Totals,200,21,53,.396,16,34,.471,5,19,.263,13,19,.684,13,23,36,16,9,4,15,18,60,False,928,Minnesota
11,School Totals,200,24,46,.522,13,22,.591,11,24,.458,23,27,.852,6,19,25,14,5,8,12,19,82,False,3124,Minnesota
11,School Totals,200,21,51,.412,17,35,.486,4,16,.250,22,34,.647,9,26,35,9,7,7,14,25,68,False,1986,Minnesota
12,School Totals,225,23,57,.404,13,31,.419,10,26,.385,19,24,.792,5,25,30,13,4,4,12,26,75,False,1315,Minnesota
10,School Totals,200,24,47,.511,21,33,.636,3,14,.214,12,16,.750,8,28,36,13,12,4,17,17,63,False,1676,Minnesota
11,School Totals,200,26,58,.448,21,42,.500,5,16,.313,16,24,.667,11,21,32,11,7,5,13,29,73,False,2876,Minnesota
11,School Totals,200,33,56,.589,29,49,.592,4,7,.571,11,11,1.000,8,19,27,16,6,3,7,21,81,False,3125,Minnesota
10,School Totals,200,26,53,.491,16,33,.485,10,20,.500,16,25,.640,7,24,31,12,9,3,13,24,78,False,3126,Minnesota
10,School Totals,200,23,50,.460,20,36,.556,3,14,.214,5,9,.556,5,20,25,15,9,2,8,13,54,False,3127,Minnesota
10,School Totals,275,29,69,.420,24,48,.500,5,21,.238,11,15,.733,11,23,34,18,10,6,14,19,74,False,3128,Minnesota
11,School Totals,200,26,58,.448,21,42,.500,5,16,.313,9,11,.818,7,20,27,14,7,5,10,15,66,False,157,Minnesota
12,School Totals,200,23,51,.451,14,34,.412,9,17,.529,15,20,.750,4,22,26,11,2,1,13,26,70,False,3129,Minnesota
11,School Totals,200,19,41,.463,13,28,.464,6,13,.462,10,18,.556,5,26,31,7,3,6,16,17,54,False,3130,Minnesota
11,School Totals,200,19,51,.373,15,26,.577,4,25,.160,7,12,.583,12,16,28,16,6,4,14,16,49,False,2608,Minnesota
10,School Totals,200,17,48,.354,13,31,.419,4,17,.235,8,8,1.000,7,16,23,7,2,1,13,16,46,False,1685,Minnesota
10,School Totals,200,30,49,.612,19,30,.633,11,19,.579,24,29,.828,6,19,25,19,9,3,13,20,95,False,2879,Minnesota
10,School Totals,200,22,48,.458,17,30,.567,5,18,.278,7,11,.636,3,19,22,10,5,1,11,15,56,False,942,Minnesota
13,School Totals,200,25,45,.556,18,25,.720,7,20,.350,24,29,.828,3,20,23,14,10,1,12,20,81,False,1995,Minnesota
11,School Totals,200,21,48,.438,14,31,.452,7,17,.412,14,23,.609,5,23,28,13,6,7,9,16,63,False,1996,Minnesota
11,School Totals,200,19,58,.328,11,37,.297,8,21,.381,11,18,.611,6,21,27,9,3,0,9,22,57,False,3131,Minnesota
11,School Totals,200,26,53,.491,20,33,.606,6,20,.300,30,36,.833,7,19,26,19,9,2,6,16,88,False,3132,Minnesota
10,School Totals,200,17,40,.425,9,20,.450,8,20,.400,21,28,.750,5,20,25,10,9,7,14,23,63,False,3133,Minnesota
12,School Totals,200,26,52,.500,16,25,.640,10,27,.370,19,21,.905,4,20,24,23,12,5,10,14,81,False,3134,Minnesota
11,School Totals,225,21,54,.389,12,34,.353,9,20,.450,16,25,.640,11,20,31,12,6,2,11,23,67,False,3135,Minnesota
11,School Totals,200,24,49,.490,17,26,.654,7,23,.304,10,17,.588,6,16,22,13,8,2,12,17,65,False,3136,Minnesota
12,School Totals,200,22,55,.400,18,37,.486,4,18,.222,20,33,.606,9,24,33,12,6,0,18,32,68,False,3137,Minnesota
13,School Totals,200,29,67,.433,21,45,.467,8,22,.364,10,19,.526,7,30,37,19,17,5,11,17,76,False,3138,Minnesota
13,School Totals,200,42,72,.583,31,57,.544,11,15,.733,14,24,.583,15,26,41,28,15,3,11,15,109,False,3139,Minnesota
13,School Totals,200,28,70,.400,22,47,.468,6,23,.261,7,14,.500,17,23,40,22,13,6,8,21,69,False,3140,Minnesota
10,School Totals,200,23,64,.359,17,45,.378,6,19,.316,9,16,.563,10,26,36,12,7,7,20,24,61,False,3141,Minnesota
11,School Totals,200,22,52,.423,12,30,.400,10,22,.455,12,23,.522,7,18,25,15,8,3,13,21,66,False,3142,Minnesota
12,School Totals,200,30,61,.492,18,37,.486,12,24,.500,12,14,.857,10,26,36,18,14,3,20,22,84,False,3143,Minnesota
11,School Totals,200,31,54,.574,24,38,.632,7,16,.438,15,23,.652,8,15,23,23,12,3,13,15,84,False,3144,Minnesota
11,School Totals,200,36,60,.600,29,46,.630,7,14,.500,13,17,.765,5,22,27,25,14,6,12,23,92,False,3145,Minnesota
11,School Totals,200,29,53,.547,22,40,.550,7,13,.538,20,29,.690,7,27,34,23,11,6,16,15,85,False,3146,Minnesota
12,School Totals,200,33,60,.550,24,35,.686,9,25,.360,17,23,.739,8,24,32,24,16,6,10,21,92,False,3147,Minnesota
11,School Totals,200,32,61,.525,26,42,.619,6,19,.316,16,26,.615,13,22,35,17,15,4,14,12,86,False,3148,Minnesota
12,School Totals,200,40,67,.597,30,51,.588,10,16,.625,18,21,.857,5,18,23,25,13,4,8,15,108,False,3149,Minnesota
10,School Totals,200,23,53,.434,15,37,.405,8,16,.500,14,20,.700,8,20,28,15,6,3,13,22,68,False,3150,Minnesota
9,School Totals,200,22,65,.338,19,43,.442,3,22,.136,11,21,.524,14,20,34,5,9,4,12,19,58,False,576,Minnesota
9,School Totals,225,27,60,.450,20,41,.488,7,19,.368,11,15,.733,9,22,31,14,11,2,14,13,72,False,1705,Minnesota
10,School Totals,200,19,49,.388,11,27,.407,8,22,.364,11,20,.550,15,21,36,10,6,1,17,15,57,False,966,Minnesota
9,School Totals,200,27,59,.458,18,34,.529,9,25,.360,12,16,.750,11,15,26,14,6,1,9,19,75,False,2897,Minnesota
10,School Totals,200,34,66,.515,24,38,.632,10,28,.357,11,17,.647,8,16,24,19,11,3,8,20,89,False,2349,Minnesota
11,School Totals,200,16,52,.308,8,32,.250,8,20,.400,9,19,.474,8,27,35,9,9,2,16,22,49,False,3151,Minnesota
11,School Totals,200,24,51,.471,15,31,.484,9,20,.450,22,29,.759,12,23,35,18,6,2,12,18,79,False,2629,Minnesota
10,School Totals,200,23,59,.390,17,37,.459,6,22,.273,6,8,.750,6,19,25,13,8,4,15,18,58,False,2016,Minnesota
13,School Totals,200,21,48,.438,17,35,.486,4,13,.308,14,17,.824,7,16,23,13,10,6,11,12,60,False,3152,Minnesota
11,School Totals,201,21,53,.396,14,38,.368,7,15,.467,13,20,.650,3,19,22,14,17,2,7,13,62,False,3153,Minnesota
10,School Totals,200,23,57,.404,17,38,.447,6,19,.316,12,19,.632,9,17,26,7,9,4,5,21,64,False,2901,Minnesota
11,School Totals,200,26,53,.491,20,33,.606,6,20,.300,13,17,.765,4,11,15,7,5,3,9,14,71,False,192,Minnesota
10,School Totals,200,25,58,.431,16,33,.485,9,25,.360,7,8,.875,11,19,30,17,5,0,10,15,66,False,3154,Minnesota
11,School Totals,200,25,54,.463,22,45,.489,3,9,.333,0,1,.000,6,22,28,7,4,2,11,17,53,False,3155,Minnesota
10,School Totals,225,29,56,.518,20,35,.571,9,21,.429,29,40,.725,4,26,30,16,6,3,7,23,96,False,1356,Minnesota
10,School Totals,200,25,61,.410,19,45,.422,6,16,.375,7,9,.778,10,21,31,12,5,3,7,16,63,False,3156,Minnesota
12,School Totals,200,25,56,.446,17,35,.486,8,21,.381,18,23,.783,6,22,28,16,3,4,9,12,76,False,2022,Minnesota
11,School Totals,200,30,58,.517,23,39,.590,7,19,.368,13,19,.684,9,21,30,17,10,2,11,12,80,False,2354,Minnesota
11,School Totals,200,28,60,.467,21,40,.525,7,20,.350,10,14,.714,7,16,23,13,6,3,13,22,73,False,1715,Minnesota
10,School Totals,200,25,55,.455,13,27,.481,12,28,.429,14,20,.700,6,25,31,20,6,7,13,12,76,False,3157,Minnesota
12,School Totals,200,22,58,.379,19,36,.528,3,22,.136,20,22,.909,6,30,36,12,4,4,12,19,67,False,3158,Minnesota
10,School Totals,200,19,50,.380,13,32,.406,6,18,.333,26,32,.813,8,22,30,8,4,5,10,21,70,False,3159,Minnesota
11,School Totals,200,25,56,.446,12,33,.364,13,23,.565,11,19,.579,7,21,28,15,3,6,12,23,74,False,3160,Minnesota
10,School Totals,200,24,57,.421,20,37,.541,4,20,.200,16,18,.889,8,19,27,7,6,1,15,26,68,False,3161,Minnesota
11,School Totals,200,32,65,.492,21,45,.467,11,20,.550,18,30,.600,11,27,38,21,8,8,9,15,93,False,3162,Minnesota
10,School Totals,200,29,55,.527,22,38,.579,7,17,.412,24,30,.800,11,19,30,18,7,4,6,13,89,False,3163,Minnesota
11,School Totals,250,24,68,.353,18,44,.409,6,24,.250,27,35,.771,14,32,46,14,7,7,16,21,81,False,3164,Minnesota
10,School Totals,200,21,57,.368,13,40,.325,8,17,.471,20,25,.800,7,21,28,10,9,5,8,14,70,False,3165,Minnesota
11,School Totals,200,19,55,.345,15,33,.455,4,22,.182,18,27,.667,11,23,34,5,6,3,10,22,60,False,3166,Minnesota
13,School Totals,200,21,54,.389,13,28,.464,8,26,.308,20,32,.625,10,26,36,15,8,7,8,10,70,False,3167,Minnesota
9,School Totals,200,28,64,.438,23,47,.489,5,17,.294,4,11,.364,7,21,28,13,4,4,11,16,65,False,3168,Minnesota
11,School Totals,200,21,58,.362,15,40,.375,6,18,.333,15,23,.652,8,24,32,8,5,0,8,22,63,False,1731,Minnesota
10,School Totals,200,22,65,.338,17,45,.378,5,20,.250,12,19,.632,12,17,29,11,5,2,3,21,61,False,1380,Minnesota
11,School Totals,200,25,48,.521,14,28,.500,11,20,.550,16,21,.762,4,19,23,11,5,1,15,24,77,False,2039,Minnesota
9,School Totals,200,18,46,.391,13,28,.464,5,18,.278,11,14,.786,2,14,16,12,4,2,11,13,52,False,3169,Minnesota
12,School Totals,200,21,51,.412,18,34,.529,3,17,.176,14,18,.778,6,12,18,7,6,3,16,19,59,False,3170,Minnesota
11,School Totals,200,19,46,.413,13,33,.394,6,13,.462,19,30,.633,2,25,27,13,5,4,14,17,63,False,218,Minnesota
11,School Totals,200,25,59,.424,19,37,.514,6,22,.273,13,17,.765,5,31,36,10,1,4,11,22,69,False,998,Minnesota
10,School Totals,225,27,69,.391,16,33,.485,11,36,.306,6,12,.500,7,28,35,21,6,1,12,19,71,False,2651,Minnesota
10,School Totals,200,26,52,.500,25,42,.595,1,10,.100,11,21,.524,1,23,24,18,5,6,10,19,64,False,3171,Minnesota
10,School Totals,200,28,68,.412,26,50,.520,2,18,.111,10,17,.588,8,24,32,11,7,2,4,23,68,False,222,Minnesota
11,School Totals,200,16,48,.333,12,30,.400,4,18,.222,22,30,.733,6,21,27,8,2,1,9,13,58,False,3172,Minnesota
10,School Totals,200,27,58,.466,23,39,.590,4,19,.211,16,19,.842,7,23,30,14,6,3,7,14,74,False,1003,Minnesota
11,School Totals,200,25,65,.385,19,43,.442,6,22,.273,15,20,.750,13,23,36,12,2,3,8,26,71,False,2923,Minnesota
10,School Totals,200,20,60,.333,12,37,.324,8,23,.348,20,23,.870,7,27,34,12,9,4,9,17,68,False,620,Minnesota
13,School Totals,200,30,65,.462,21,43,.488,9,22,.409,14,24,.583,11,31,42,18,12,6,14,15,83,False,2375,Minnesota
8,School Totals,200,27,61,.443,19,41,.463,8,20,.400,9,11,.818,10,19,29,9,3,2,17,20,71,False,2656,Minnesota
10,School Totals,200,16,48,.333,13,31,.419,3,17,.176,14,21,.667,9,22,31,11,3,2,12,18,49,False,3173,Minnesota
9,School Totals,200,22,73,.301,20,56,.357,2,17,.118,6,9,.667,17,19,36,8,7,4,16,17,52,False,2377,Minnesota
9,School Totals,200,20,51,.392,16,39,.410,4,12,.333,8,12,.667,5,21,26,7,5,1,15,14,52,False,2657,Minnesota
14,School Totals,200,27,53,.509,17,28,.607,10,25,.400,22,32,.688,8,28,36,17,6,5,19,26,86,False,3174,Minnesota
14,School Totals,200,25,60,.417,21,37,.568,4,23,.174,30,40,.750,15,30,45,14,7,6,8,19,84,False,3175,Minnesota
15,School Totals,200,31,54,.574,27,39,.692,4,15,.267,14,23,.609,7,36,43,19,3,5,16,17,80,False,3176,Minnesota
11,School Totals,200,31,71,.437,24,54,.444,7,17,.412,23,29,.793,10,30,40,18,4,11,6,19,92,False,3177,Minnesota
13,School Totals,200,29,56,.518,20,41,.488,9,15,.600,18,25,.720,9,18,27,17,7,8,14,19,85,False,3178,Minnesota
10,School Totals,200,21,55,.382,18,39,.462,3,16,.188,12,22,.545,11,28,39,13,4,5,10,9,57,False,3179,Minnesota
11,School Totals,200,19,59,.322,12,38,.316,7,21,.333,22,36,.611,10,21,31,8,5,4,17,28,67,False,3180,Minnesota
9,School Totals,200,23,59,.390,20,50,.400,3,9,.333,7,15,.467,8,30,38,15,7,8,9,7,56,False,3181,Minnesota
11,School Totals,200,21,51,.412,12,30,.400,9,21,.429,23,29,.793,6,37,43,11,2,10,14,17,74,False,3182,Minnesota
14,School Totals,200,32,73,.438,20,39,.513,12,34,.353,10,16,.625,15,33,48,23,10,9,9,13,86,False,3183,Minnesota
11,School Totals,200,24,58,.414,20,43,.465,4,15,.267,25,30,.833,13,29,42,17,9,4,14,16,77,False,3184,Minnesota
10,School Totals,200,29,63,.460,21,42,.500,8,21,.381,10,13,.769,9,18,27,20,7,5,10,12,76,False,3185,Minnesota
10,School Totals,200,26,49,.531,19,35,.543,7,14,.500,23,35,.657,2,20,22,19,11,1,15,18,82,False,3186,Minnesota
10,School Totals,225,20,53,.377,17,40,.425,3,13,.231,31,45,.689,9,34,43,11,5,8,15,20,74,False,1410,Minnesota
10,School Totals,225,35,71,.493,27,50,.540,8,21,.381,13,19,.684,5,29,34,17,9,8,6,18,91,False,3187,Minnesota
10,School Totals,200,25,57,.439,19,38,.500,6,19,.316,14,22,.636,10,27,37,16,5,5,8,10,70,False,3188,Minnesota
10,School Totals,200,25,61,.410,16,37,.432,9,24,.375,19,27,.704,8,25,33,20,7,12,11,17,78,False,1761,Minnesota
10,School Totals,200,19,57,.333,16,41,.390,3,16,.188,6,7,.857,5,21,26,6,4,4,12,16,47,False,1414,Minnesota
10,School Totals,200,20,53,.377,18,46,.391,2,7,.286,8,11,.727,5,26,31,8,8,5,19,15,50,False,2065,Minnesota
10,School Totals,225,30,64,.469,21,47,.447,9,17,.529,7,10,.700,6,23,29,19,6,7,9,13,76,False,3189,Minnesota
9,School Totals,200,25,61,.410,17,37,.459,8,24,.333,14,20,.700,8,20,28,12,7,4,12,23,72,False,1765,Minnesota
10,School Totals,200,25,60,.417,16,43,.372,9,17,.529,19,24,.792,12,26,38,21,1,10,10,18,78,False,648,Minnesota
10,School Totals,200,24,64,.375,17,45,.378,7,19,.368,13,18,.722,12,24,36,10,2,4,5,15,68,False,2676,Minnesota
11,School Totals,250,36,82,.439,28,58,.483,8,24,.333,21,31,.677,17,30,47,20,10,14,12,21,101,False,2945,Minnesota
10,School Totals,200,28,60,.467,25,43,.581,3,17,.176,13,15,.867,11,24,35,16,6,5,11,18,72,False,2398,Minnesota
9,School Totals,200,24,62,.387,18,44,.409,6,18,.333,21,28,.750,13,26,39,14,5,9,12,16,75,False,262,Minnesota
10,School Totals,225,25,57,.439,20,44,.455,5,13,.385,28,41,.683,12,31,43,14,3,3,11,17,83,False,1036,Minnesota
10,School Totals,200,32,64,.500,24,42,.571,8,22,.364,17,20,.850,6,29,35,8,4,8,5,15,89,False,655,Minnesota
10,School Totals,200,29,65,.446,22,45,.489,7,20,.350,16,23,.696,8,36,44,20,2,15,10,15,81,False,2073,Minnesota
14,School Totals,200,33,59,.559,28,45,.622,5,14,.357,17,25,.680,5,25,30,21,9,11,16,16,88,False,3190,Minnesota
10,School Totals,200,18,56,.321,15,43,.349,3,13,.231,10,17,.588,10,26,36,7,7,5,11,19,49,False,3191,Minnesota
10,School Totals,200,21,51,.412,17,39,.436,4,12,.333,17,23,.739,8,23,31,10,5,5,9,18,63,False,1425,Minnesota
8,School Totals,200,31,67,.463,28,54,.519,3,13,.231,12,14,.857,15,23,38,11,2,1,11,16,77,False,1043,Minnesota
10,School Totals,200,24,52,.462,18,31,.581,6,21,.286,18,21,.857,3,19,22,15,5,3,8,21,72,False,3192,Minnesota
10,School Totals,200,32,70,.457,23,42,.548,9,28,.321,19,31,.613,19,30,49,20,3,6,12,16,92,False,3193,Minnesota
10,School Totals,200,30,59,.508,25,42,.595,5,17,.294,21,27,.778,9,28,37,6,3,7,11,21,86,False,3194,Minnesota
13,School Totals,200,42,78,.538,31,53,.585,11,25,.440,12,22,.545,16,27,43,32,5,12,4,13,107,False,3195,Minnesota
11,School Totals,200,29,58,.500,22,42,.524,7,16,.438,27,38,.711,12,25,37,19,11,9,11,20,92,False,3196,Minnesota
14,School Totals,200,43,70,.614,38,54,.704,5,16,.313,9,16,.563,12,26,38,28,10,10,9,10,100,False,3197,Minnesota
11,School Totals,200,27,63,.429,20,46,.435,7,17,.412,8,13,.615,6,34,40,14,8,4,16,14,69,False,3198,Minnesota
11,School Totals,200,30,66,.455,22,47,.468,8,19,.421,21,27,.778,15,23,38,16,7,6,12,24,89,False,3199,Minnesota
10,School Totals,200,28,63,.444,23,47,.489,5,16,.313,20,26,.769,14,25,39,12,4,12,12,13,81,False,3200,Minnesota
12,School Totals,200,28,61,.459,22,46,.478,6,15,.400,27,35,.771,8,34,42,23,5,8,13,16,89,False,2410,Minnesota
11,School Totals,200,22,68,.324,16,52,.308,6,16,.375,18,24,.750,14,21,35,9,6,4,12,23,68,False,3201,Minnesota
10,School Totals,200,25,61,.410,20,42,.476,5,19,.263,24,37,.649,9,25,34,10,3,2,10,19,79,False,3202,Minnesota
10,School Totals,200,27,59,.458,22,41,.537,5,18,.278,9,14,.643,12,28,40,17,4,10,14,9,68,False,3203,Minnesota
11,School Totals,200,24,63,.381,18,44,.409,6,19,.316,23,28,.821,11,25,36,17,8,7,9,14,77,False,3204,Minnesota
13,School Totals,200,35,64,.547,24,39,.615,11,25,.440,14,18,.778,6,37,43,25,4,5,7,9,95,False,3205,Minnesota
10,School Totals,200,20,60,.333,13,39,.333,7,21,.333,18,20,.900,14,32,46,15,3,8,11,10,65,False,3206,Minnesota
10,School Totals,200,25,55,.455,20,35,.571,5,20,.250,22,34,.647,14,30,44,14,6,10,15,14,77,False,2698,Minnesota
10,School Totals,200,25,59,.424,16,36,.444,9,23,.391,12,16,.750,6,26,32,15,7,9,14,12,71,False,285,Minnesota
10,School Totals,200,17,55,.309,9,31,.290,8,24,.333,18,22,.818,5,20,25,14,6,3,8,18,60,False,3207,Minnesota
10,School Totals,200,17,59,.288,13,38,.342,4,21,.190,9,11,.818,7,19,26,12,7,1,8,8,47,False,3208,Minnesota
11,School Totals,225,35,66,.530,25,49,.510,10,17,.588,15,23,.652,8,34,42,12,2,3,11,14,95,False,2093,Minnesota
10,School Totals,200,23,64,.359,17,47,.362,6,17,.353,14,17,.824,11,17,28,11,5,3,10,18,66,False,681,Minnesota
11,School Totals,200,18,47,.383,15,33,.455,3,14,.214,10,20,.500,5,27,32,8,3,2,15,11,49,False,1789,Minnesota
10,School Totals,200,25,59,.424,16,35,.457,9,24,.375,10,16,.625,10,19,29,19,8,1,11,15,69,False,3209,Minnesota
9,School Totals,200,30,67,.448,23,42,.548,7,25,.280,13,20,.650,12,23,35,17,6,5,8,17,80,False,2965,Minnesota
8,School Totals,225,28,63,.444,23,45,.511,5,18,.278,12,19,.632,4,26,30,6,2,2,5,20,73,False,1070,Minnesota
9,School Totals,200,33,67,.493,23,48,.479,10,19,.526,9,15,.600,7,22,29,23,5,4,6,17,85,False,3210,Minnesota
9,School Totals,200,20,60,.333,14,39,.359,6,21,.286,10,14,.714,11,19,30,4,6,2,14,15,56,False,295,Minnesota
9,School Totals,200,19,59,.322,11,37,.297,8,22,.364,11,13,.846,4,15,19,10,8,1,8,16,57,False,1450,Minnesota
9,School Totals,225,25,58,.431,19,42,.452,6,16,.375,7,8,.875,6,26,32,11,8,0,15,17,63,False,3211,Minnesota
9,School Totals,200,27,61,.443,18,36,.500,9,25,.360,23,35,.657,9,24,33,16,10,3,8,16,86,False,2966,Minnesota
10,School Totals,200,23,57,.404,16,39,.410,7,18,.389,7,11,.636,8,19,27,6,2,0,12,13,60,False,3212,Minnesota
10,School Totals,200,18,52,.346,15,33,.455,3,19,.158,15,22,.682,3,22,25,6,6,4,9,20,54,False,2426,Minnesota
13,School Totals,195,39,62,.629,29,41,.707,10,21,.476,16,23,.696,11,27,38,28,5,4,18,16,104,False,3213,Minnesota
10,School Totals,200,29,56,.518,22,37,.595,7,19,.368,13,18,.722,6,25,31,20,4,7,10,19,78,False,3214,Minnesota
11,School Totals,200,22,52,.423,15,34,.441,7,18,.389,18,32,.563,13,20,33,11,6,3,20,20,69,False,3215,Minnesota
11,School Totals,200,24,67,.358,15,44,.341,9,23,.391,23,38,.605,11,25,36,12,2,4,9,14,80,False,3216,Minnesota
11,School Totals,200,21,55,.382,17,43,.395,4,12,.333,22,33,.667,13,17,30,8,6,1,14,21,68,False,3217,Minnesota
11,School Totals,200,19,65,.292,14,35,.400,5,30,.167,13,17,.765,12,23,35,13,4,1,9,23,56,False,3218,Minnesota
10,School Totals,200,26,50,.520,18,36,.500,8,14,.571,23,30,.767,6,27,33,18,4,8,18,20,83,False,3219,Minnesota
11,School Totals,200,20,51,.392,20,38,.526,0,13,.000,19,32,.594,8,22,30,7,2,4,12,20,59,False,1807,Minnesota
11,School Totals,200,29,56,.518,26,48,.542,3,8,.375,24,32,.750,13,22,35,15,4,5,13,15,85,False,3220,Minnesota
11,School Totals,200,24,54,.444,16,37,.432,8,17,.471,16,24,.667,13,25,38,19,5,6,13,14,72,False,3221,Minnesota
10,School Totals,200,26,67,.388,25,52,.481,1,15,.067,27,39,.692,22,27,49,16,7,4,10,12,80,False,3222,Minnesota
11,School Totals,200,34,74,.459,30,54,.556,4,20,.200,14,23,.609,19,26,45,24,11,7,13,17,86,False,3223,Minnesota
11,School Totals,200,22,52,.423,18,33,.545,4,19,.211,23,30,.767,10,29,39,13,6,9,12,15,71,False,3224,Minnesota
10,School Totals,200,21,48,.438,15,34,.441,6,14,.429,11,17,.647,5,29,34,8,7,0,13,19,59,False,3225,Minnesota
11,School Totals,200,26,62,.419,20,46,.435,6,16,.375,9,23,.391,9,15,24,18,6,3,6,19,67,False,707,Minnesota
13,School Totals,200,29,58,.500,19,34,.559,10,24,.417,20,25,.800,7,25,32,24,7,5,8,14,88,False,2439,Minnesota
12,School Totals,200,26,59,.441,23,45,.511,3,14,.214,13,19,.684,9,16,25,8,7,4,13,15,68,False,2719,Minnesota
8,School Totals,200,20,50,.400,17,36,.472,3,14,.214,22,30,.733,8,22,30,16,7,4,11,20,65,False,2121,Minnesota
11,School Totals,200,21,52,.404,16,37,.432,5,15,.333,10,14,.714,11,26,37,8,2,4,16,17,57,False,1103,Minnesota
10,School Totals,200,32,56,.571,25,38,.658,7,18,.389,21,31,.677,6,17,23,25,7,3,9,17,92,False,2983,Minnesota
10,School Totals,200,30,60,.500,24,41,.585,6,19,.316,20,26,.769,9,23,32,16,2,2,8,18,86,False,2722,Minnesota
11,School Totals,200,24,57,.421,22,41,.537,2,16,.125,13,16,.813,8,23,31,15,3,3,10,15,63,False,3226,Minnesota
10,School Totals,200,20,57,.351,19,44,.432,1,13,.077,10,13,.769,12,29,41,10,4,8,9,16,51,False,3227,Minnesota
11,School Totals,200,18,49,.367,13,35,.371,5,14,.357,14,23,.609,6,23,29,14,1,1,12,14,55,False,1478,Minnesota
10,School Totals,200,25,54,.463,19,40,.475,6,14,.429,5,8,.625,7,18,25,12,4,4,9,14,61,False,3228,Minnesota
13,School Totals,200,28,58,.483,16,36,.444,12,22,.545,16,23,.696,9,25,34,19,3,1,10,19,84,False,325,Minnesota
9,School Totals,200,25,67,.373,24,57,.421,1,10,.100,9,18,.500,13,29,42,13,4,2,8,13,60,False,1109,Minnesota
10,School Totals,200,23,54,.426,15,39,.385,8,15,.533,10,20,.500,7,20,27,9,3,4,11,18,64,False,2446,Minnesota
9,School Totals,200,21,51,.412,16,37,.432,5,14,.357,15,19,.789,5,32,37,9,8,5,12,13,62,False,3229,Minnesota
9,School Totals,200,21,49,.429,17,35,.486,4,14,.286,27,36,.750,7,31,38,13,7,9,14,15,73,False,3230,Minnesota
9,School Totals,200,21,55,.382,13,32,.406,8,23,.348,10,15,.667,6,23,29,13,4,4,13,10,60,False,721,Minnesota
9,School Totals,225,25,57,.439,22,46,.478,3,11,.273,24,31,.774,6,25,31,18,4,1,8,15,77,False,2131,Minnesota
9,School Totals,200,27,54,.500,22,41,.537,5,13,.385,16,21,.762,8,23,31,16,4,4,9,12,75,False,3231,Minnesota
11,School Totals,200,22,54,.407,20,42,.476,2,12,.167,3,9,.333,5,21,26,18,3,2,8,11,49,False,1114,Minnesota
9,School Totals,200,29,58,.500,18,31,.581,11,27,.407,17,26,.654,9,23,32,10,2,3,4,15,86,False,3232,Minnesota
11,School Totals,200,18,59,.305,16,37,.432,2,22,.091,12,14,.857,5,11,16,7,10,1,5,13,50,False,1486,Minnesota
10,School Totals,200,31,57,.544,18,28,.643,13,29,.448,10,14,.714,7,29,36,26,5,8,16,13,85,False,3233,Minnesota
10,School Totals,200,25,63,.397,17,31,.548,8,32,.250,4,12,.333,8,23,31,11,3,5,13,20,62,False,3234,Minnesota
10,School Totals,200,17,51,.333,11,28,.393,6,23,.261,16,21,.762,8,24,32,12,5,5,15,25,56,False,3235,Minnesota
10,School Totals,200,26,74,.351,14,41,.341,12,33,.364,5,12,.417,14,21,35,11,11,4,4,23,69,False,3236,Minnesota
12,School Totals,200,32,63,.508,18,33,.545,14,30,.467,4,7,.571,6,32,38,23,7,6,16,11,82,False,3237,Minnesota
12,School Totals,200,32,63,.508,23,43,.535,9,20,.450,6,9,.667,8,29,37,19,8,4,15,14,79,False,3238,Minnesota
10,School Totals,200,21,61,.344,14,32,.438,7,29,.241,19,30,.633,15,22,37,12,4,6,10,19,68,False,3239,Minnesota
13,School Totals,200,28,52,.538,20,30,.667,8,22,.364,14,19,.737,2,22,24,17,3,5,8,19,78,False,3240,Minnesota
11,School Totals,200,21,57,.368,15,32,.469,6,25,.240,4,8,.500,8,23,31,14,2,9,14,14,52,False,2997,Minnesota
9,School Totals,200,31,57,.544,24,38,.632,7,19,.368,15,20,.750,9,27,36,16,8,4,16,17,84,False,1836,Minnesota
9,School Totals,200,32,55,.582,22,34,.647,10,21,.476,12,13,.923,7,23,30,17,4,3,16,16,86,False,3241,Minnesota
12,School Totals,200,26,67,.388,18,43,.419,8,24,.333,29,30,.967,14,35,49,17,10,5,14,16,89,False,3242,Minnesota
10,School Totals,250,27,74,.365,18,48,.375,9,26,.346,15,19,.789,16,28,44,13,8,5,18,23,78,False,3243,Minnesota
10,School Totals,200,25,61,.410,17,32,.531,8,29,.276,19,19,1.000,14,27,41,19,5,8,11,14,77,False,3244,Minnesota
10,School Totals,200,23,59,.390,18,39,.462,5,20,.250,7,8,.875,7,21,28,14,3,7,11,19,58,False,1504,Minnesota
8,School Totals,200,28,51,.549,24,35,.686,4,16,.250,15,27,.556,6,27,33,16,4,1,5,7,75,False,1134,Minnesota
9,School Totals,200,23,60,.383,17,36,.472,6,24,.250,23,29,.793,16,29,45,14,3,4,9,18,75,False,2146,Minnesota
9,School Totals,200,19,53,.358,10,25,.400,9,28,.321,9,15,.600,10,20,30,11,4,4,7,15,56,False,2463,Minnesota
9,School Totals,200,23,54,.426,16,33,.485,7,21,.333,9,17,.529,3,27,30,8,2,1,4,18,62,False,1843,Minnesota
12,School Totals,200,16,57,.281,11,29,.379,5,28,.179,15,20,.750,10,21,31,13,5,2,11,15,52,False,1507,Minnesota
11,School Totals,200,19,60,.317,16,41,.390,3,19,.158,10,12,.833,5,27,32,4,3,6,11,16,51,False,2744,Minnesota
9,School Totals,200,25,61,.410,16,39,.410,9,22,.409,11,16,.688,8,33,41,16,5,5,5,15,70,False,3245,Minnesota
11,School Totals,200,29,67,.433,21,43,.488,8,24,.333,11,13,.846,8,24,32,11,3,3,6,20,77,False,2148,Minnesota
10,School Totals,200,21,59,.356,14,34,.412,7,25,.280,6,12,.500,9,25,34,18,3,7,11,17,55,False,3006,Minnesota
11,School Totals,200,21,61,.344,17,36,.472,4,25,.160,10,19,.526,12,24,36,18,6,4,12,20,56,False,361,Minnesota
13,School Totals,200,30,62,.484,16,32,.500,14,30,.467,9,15,.600,10,34,44,19,3,4,10,13,83,False,3246,Minnesota
9,School Totals,200,26,57,.456,16,33,.485,10,24,.417,11,18,.611,8,23,31,17,4,4,12,17,73,False,750,Minnesota
10,School Totals,200,26,58,.448,22,39,.564,4,19,.211,13,23,.565,10,28,38,6,1,4,9,21,69,False,3247,Minnesota
9,School Totals,200,26,60,.433,19,44,.432,7,16,.438,8,14,.571,10,23,33,8,3,0,11,15,67,False,365,Minnesota
14,School Totals,200,41,72,.569,23,37,.622,18,35,.514,7,12,.583,12,31,43,32,5,7,12,16,107,False,3248,Minnesota
12,School Totals,200,26,65,.400,14,41,.341,12,24,.500,10,12,.833,12,27,39,14,7,4,5,9,74,False,3249,Minnesota
12,School Totals,200,34,79,.430,27,45,.600,7,34,.206,24,30,.800,12,31,43,17,13,4,13,21,99,False,3250,Minnesota
11,School Totals,200,30,65,.462,22,50,.440,8,15,.533,20,28,.714,8,28,36,22,7,3,11,17,88,False,3251,Minnesota
11,School Totals,200,23,54,.426,19,38,.500,4,16,.250,17,24,.708,7,19,26,12,7,4,10,25,67,False,3252,Minnesota
11,School Totals,200,28,60,.467,23,44,.523,5,16,.313,15,22,.682,7,22,29,18,8,8,13,15,76,False,3253,Minnesota
11,School Totals,225,28,64,.438,22,39,.564,6,25,.240,23,33,.697,9,29,38,17,5,1,12,16,85,False,3254,Minnesota
14,School Totals,200,24,52,.462,16,28,.571,8,24,.333,34,44,.773,9,29,38,18,4,9,7,19,90,False,3255,Minnesota
12,School Totals,200,19,69,.275,12,41,.293,7,28,.250,20,32,.625,10,22,32,10,7,6,8,19,65,False,2755,Minnesota
11,School Totals,200,23,48,.479,13,23,.565,10,25,.400,34,41,.829,5,27,32,16,6,9,19,20,90,False,3256,Minnesota
10,School Totals,225,30,67,.448,13,24,.542,17,43,.395,25,29,.862,11,24,35,22,3,5,8,23,102,False,3016,Minnesota
14,School Totals,200,30,63,.476,24,38,.632,6,25,.240,15,17,.882,9,40,49,18,5,4,13,13,81,False,1524,Minnesota
10,School Totals,200,20,64,.313,13,33,.394,7,31,.226,12,14,.857,15,23,38,12,1,6,10,15,59,False,3257,Minnesota
13,School Totals,200,24,55,.436,15,33,.455,9,22,.409,20,29,.690,9,29,38,15,5,6,8,20,77,False,1861,Minnesota
12,School Totals,200,22,68,.324,15,40,.375,7,28,.250,6,6,1.000,13,15,28,6,7,2,11,15,57,False,1156,Minnesota
10,School Totals,200,25,71,.352,15,37,.405,10,34,.294,11,16,.688,11,23,34,15,7,2,7,17,71,False,3018,Minnesota
12,School Totals,200,29,62,.468,25,44,.568,4,18,.222,13,15,.867,6,28,34,19,12,2,7,17,75,False,1158,Minnesota
10,School Totals,200,14,46,.304,9,23,.391,5,23,.217,16,25,.640,6,22,28,8,5,6,11,21,49,False,768,Minnesota
11,School Totals,200,22,57,.386,12,29,.414,10,28,.357,8,11,.727,8,16,24,15,6,7,11,21,62,False,3258,Minnesota
10,School Totals,200,26,64,.406,20,46,.435,6,18,.333,14,17,.824,14,16,30,14,7,1,11,20,72,False,2480,Minnesota
11,School Totals,200,27,72,.375,19,36,.528,8,36,.222,17,22,.773,11,28,39,15,4,4,9,24,79,False,3259,Minnesota
10,School Totals,200,27,60,.450,20,36,.556,7,24,.292,10,14,.714,10,21,31,13,4,5,10,14,71,False,3260,Minnesota
10,School Totals,200,19,59,.322,11,31,.355,8,28,.286,13,18,.722,12,19,31,7,6,4,6,15,59,False,773,Minnesota
10,School Totals,200,24,60,.400,20,40,.500,4,20,.200,20,29,.690,13,10,23,6,8,4,7,23,72,False,388,Minnesota
11,School Totals,200,22,54,.407,14,38,.368,8,16,.500,11,15,.733,5,20,25,16,2,9,17,15,63,False,2762,Minnesota
9,School Totals,200,23,62,.371,19,35,.543,4,27,.148,9,10,.900,8,21,29,14,12,0,14,24,59,False,3261,Minnesota
9,School Totals,200,24,70,.343,16,40,.400,8,30,.267,18,24,.750,10,22,32,7,7,3,9,16,74,False,3262,Minnesota
9,School Totals,200,21,59,.356,16,41,.390,5,18,.278,18,24,.750,7,22,29,11,5,5,7,16,65,False,2170,Minnesota
9,School Totals,225,20,64,.313,14,38,.368,6,26,.231,24,29,.828,11,27,38,11,6,3,13,21,70,False,2484,Minnesota
9,School Totals,200,18,49,.367,13,29,.448,5,20,.250,10,24,.417,7,28,35,10,7,5,17,13,51,False,3263,Minnesota
9,School Totals,200,28,77,.364,20,45,.444,8,32,.250,11,17,.647,12,26,38,15,7,7,11,23,75,False,1872,Minnesota
13,School Totals,200,28,58,.483,17,38,.447,11,20,.550,9,16,.563,15,19,34,19,12,4,14,11,76,False,3264,Nebraska
11,School Totals,200,20,50,.400,19,43,.442,1,7,.143,14,20,.700,7,23,30,9,6,0,14,22,55,False,3265,Nebraska
12,School Totals,200,27,50,.540,21,37,.568,6,13,.462,30,41,.732,12,20,32,19,11,4,16,23,90,False,3266,Nebraska
14,School Totals,200,26,49,.531,20,37,.541,6,12,.500,12,20,.600,3,25,28,16,6,7,7,16,70,False,3267,Nebraska
10,School Totals,200,21,50,.420,15,36,.417,6,14,.429,3,11,.273,4,18,22,11,11,2,7,18,51,False,3268,Nebraska
15,School Totals,200,29,54,.537,20,42,.476,9,12,.750,14,19,.737,8,19,27,16,9,7,10,16,81,False,3269,Nebraska
10,School Totals,200,24,48,.500,20,30,.667,4,18,.222,9,14,.643,3,20,23,15,7,3,19,25,61,False,3270,Nebraska
14,School Totals,200,25,45,.556,18,29,.621,7,16,.438,17,25,.680,10,30,40,17,5,4,17,22,74,False,3271,Nebraska
9,School Totals,200,19,52,.365,16,33,.485,3,19,.158,9,13,.692,9,23,32,8,7,5,11,15,50,False,3272,Nebraska
14,School Totals,200,22,53,.415,19,39,.487,3,14,.214,10,22,.455,9,26,35,12,6,3,12,17,57,False,3273,Nebraska
12,School Totals,200,27,57,.474,19,38,.500,8,19,.421,12,16,.750,11,19,30,13,6,2,11,18,74,False,3274,Nebraska
13,School Totals,200,22,52,.423,16,38,.421,6,14,.429,16,23,.696,6,14,20,14,5,2,14,24,66,False,3275,Nebraska
14,School Totals,200,33,61,.541,25,40,.625,8,21,.381,20,32,.625,11,22,33,18,8,3,4,16,94,False,3276,Nebraska
14,School Totals,200,26,57,.456,18,37,.486,8,20,.400,14,22,.636,7,23,30,20,7,4,13,15,74,False,3277,Nebraska
14,School Totals,200,27,59,.458,15,40,.375,12,19,.632,11,16,.688,11,18,29,19,8,3,6,9,77,False,3278,Nebraska
11,School Totals,200,20,54,.370,13,32,.406,7,22,.318,6,9,.667,7,18,25,16,7,2,13,27,53,False,3279,Nebraska
8,School Totals,200,23,53,.434,12,32,.375,11,21,.524,15,21,.714,6,11,17,18,5,2,9,20,72,False,3280,Nebraska
10,School Totals,200,23,63,.365,18,44,.409,5,19,.263,2,8,.250,8,25,33,10,10,4,9,13,53,False,3281,Nebraska
11,School Totals,200,18,44,.409,14,28,.500,4,16,.250,13,17,.765,6,22,28,8,4,2,12,16,53,False,3282,Nebraska
12,School Totals,200,19,48,.396,14,31,.452,5,17,.294,17,21,.810,10,19,29,10,6,1,16,22,60,False,3283,Nebraska
11,School Totals,200,24,54,.444,19,43,.442,5,11,.455,10,14,.714,10,24,34,11,6,3,9,15,63,False,3284,Nebraska
12,School Totals,200,20,48,.417,15,39,.385,5,9,.556,12,21,.571,4,20,24,15,2,0,16,18,57,False,3285,Nebraska
12,School Totals,200,23,54,.426,13,37,.351,10,17,.588,8,15,.533,12,20,32,14,9,3,18,24,64,False,3286,Nebraska
12,School Totals,200,18,57,.316,14,36,.389,4,21,.190,13,16,.813,7,15,22,11,3,2,3,21,53,False,3287,Nebraska
13,School Totals,200,16,57,.281,14,39,.359,2,18,.111,17,27,.630,10,17,27,9,8,2,12,24,51,False,3288,Nebraska
11,School Totals,200,28,48,.583,14,27,.519,14,21,.667,17,23,.739,4,23,27,23,7,0,20,27,87,False,3289,Nebraska
11,School Totals,200,20,46,.435,14,30,.467,6,16,.375,13,20,.650,6,18,24,14,5,3,17,20,59,False,3290,Nebraska
10,School Totals,200,27,58,.466,18,39,.462,9,19,.474,11,16,.688,5,22,27,19,7,2,13,22,74,False,3291,Nebraska
12,School Totals,250,24,69,.348,15,47,.319,9,22,.409,26,36,.722,13,34,47,12,6,7,13,17,83,False,3292,Nebraska
11,School Totals,200,22,58,.379,17,44,.386,5,14,.357,19,26,.731,18,20,38,9,9,1,13,20,68,False,3293,Nebraska
11,School Totals,200,20,50,.400,17,37,.459,3,13,.231,12,18,.667,8,22,30,10,7,3,17,19,55,False,3294,Nebraska
10,School Totals,200,24,43,.558,16,29,.552,8,14,.571,19,22,.864,6,27,33,17,4,1,13,17,75,False,3295,Nebraska
11,School Totals,200,23,46,.500,16,27,.593,7,19,.368,11,14,.786,4,21,25,19,4,3,14,17,64,False,3296,Nebraska
13,School Totals,200,27,62,.435,24,48,.500,3,14,.214,19,21,.905,11,29,40,17,5,3,14,12,76,False,3297,Nebraska
13,School Totals,200,29,46,.630,22,26,.846,7,20,.350,18,27,.667,5,31,36,19,2,3,14,20,83,False,3298,Nebraska
12,School Totals,200,18,51,.353,18,41,.439,0,10,.000,13,23,.565,8,26,34,8,4,3,15,23,49,False,3299,Nebraska
11,School Totals,200,21,47,.447,19,36,.528,2,11,.182,23,31,.742,6,28,34,10,10,6,15,22,67,False,3300,Nebraska
14,School Totals,200,23,42,.548,17,30,.567,6,12,.500,10,15,.667,6,25,31,15,8,4,13,18,62,False,3301,Nebraska
12,School Totals,210,24,48,.500,18,33,.545,6,15,.400,6,11,.545,6,20,26,12,7,5,13,12,60,False,3302,Nebraska
11,School Totals,200,30,50,.600,21,31,.677,9,19,.474,7,10,.700,9,20,29,20,7,1,11,14,76,False,3303,Nebraska
11,School Totals,200,22,59,.373,13,28,.464,9,31,.290,6,8,.750,6,29,35,14,2,3,8,11,59,False,3304,Nebraska
13,School Totals,200,29,60,.483,26,43,.605,3,17,.176,17,27,.630,11,34,45,18,13,5,18,16,78,False,3305,Nebraska
11,School Totals,200,24,48,.500,14,31,.452,10,17,.588,12,15,.800,7,30,37,9,5,3,17,14,70,False,3306,Nebraska
14,School Totals,200,28,56,.500,24,38,.632,4,18,.222,12,18,.667,10,32,42,10,10,8,13,20,72,False,3307,Nebraska
14,School Totals,200,33,62,.532,31,49,.633,2,13,.154,11,16,.688,8,37,45,12,8,4,14,12,79,False,3308,Nebraska
14,School Totals,200,31,56,.554,24,36,.667,7,20,.350,8,13,.615,7,30,37,15,5,6,10,14,77,False,3309,Nebraska
15,School Totals,200,25,45,.556,22,33,.667,3,12,.250,15,20,.750,6,26,32,12,4,9,13,11,68,False,3310,Nebraska
11,School Totals,200,22,60,.367,18,43,.419,4,17,.235,15,24,.625,13,27,40,13,10,6,7,13,63,False,3311,Nebraska
11,School Totals,200,25,59,.424,19,42,.452,6,17,.353,13,16,.813,7,23,30,12,5,1,15,25,69,False,3312,Nebraska
11,School Totals,200,22,61,.361,19,48,.396,3,13,.231,13,16,.813,16,23,39,12,7,2,14,19,60,False,3313,Nebraska
11,School Totals,200,30,53,.566,26,36,.722,4,17,.235,15,18,.833,7,24,31,18,8,3,13,14,79,False,3314,Nebraska
11,School Totals,200,23,51,.451,17,35,.486,6,16,.375,19,26,.731,7,16,23,11,5,1,13,21,71,False,3315,Nebraska
10,School Totals,200,21,48,.438,18,33,.545,3,15,.200,12,17,.706,5,20,25,9,6,2,7,14,57,False,3316,Nebraska
11,School Totals,200,19,43,.442,16,31,.516,3,12,.250,12,16,.750,5,15,20,6,8,0,22,22,53,False,3317,Nebraska
11,School Totals,200,23,56,.411,16,36,.444,7,20,.350,13,17,.765,5,22,27,13,7,3,13,24,66,False,3318,Nebraska
10,School Totals,200,23,51,.451,15,32,.469,8,19,.421,16,19,.842,5,16,21,17,8,1,15,24,70,False,3319,Nebraska
11,School Totals,200,22,50,.440,16,31,.516,6,19,.316,15,18,.833,11,24,35,13,8,3,13,18,65,False,3320,Nebraska
10,School Totals,200,23,44,.523,18,29,.621,5,15,.333,8,13,.615,3,23,26,14,5,5,11,13,59,False,3321,Nebraska
10,School Totals,200,24,51,.471,20,41,.488,4,10,.400,18,25,.720,9,22,31,12,6,2,11,22,70,False,3322,Nebraska
10,School Totals,200,17,49,.347,12,36,.333,5,13,.385,18,27,.667,8,22,30,10,7,6,17,23,57,False,3323,Nebraska
11,School Totals,225,32,67,.478,20,45,.444,12,22,.545,6,13,.462,12,21,33,15,6,3,8,18,82,False,3324,Nebraska
11,School Totals,200,25,47,.532,20,34,.588,5,13,.385,14,23,.609,9,23,32,17,8,5,17,9,69,False,3325,Nebraska
12,School Totals,200,22,50,.440,16,32,.500,6,18,.333,7,15,.467,6,26,32,14,3,4,15,17,57,False,3326,Nebraska
10,School Totals,200,19,55,.345,15,36,.417,4,19,.211,10,15,.667,10,22,32,12,4,4,10,17,52,False,3327,Nebraska
12,School Totals,200,17,50,.340,15,32,.469,2,18,.111,13,17,.765,12,17,29,6,7,1,16,18,49,False,3328,Nebraska
12,School Totals,200,23,53,.434,16,39,.410,7,14,.500,12,19,.632,13,29,42,9,8,6,18,14,65,False,3329,Nebraska
10,School Totals,250,19,52,.365,10,32,.313,9,20,.450,17,23,.739,8,29,37,9,4,4,19,21,64,False,3330,Nebraska
13,School Totals,200,32,56,.571,22,33,.667,10,23,.435,9,12,.750,6,23,29,24,10,1,13,17,83,False,3331,Nebraska
10,School Totals,200,24,51,.471,17,32,.531,7,19,.368,21,25,.840,3,25,28,15,4,5,14,26,76,False,3332,Nebraska
11,School Totals,200,28,57,.491,23,43,.535,5,14,.357,15,18,.833,7,29,36,13,8,3,12,20,76,False,3333,Nebraska
9,School Totals,200,22,57,.386,16,34,.471,6,23,.261,3,4,.750,6,22,28,14,5,6,8,13,53,False,3334,Nebraska
10,School Totals,200,24,56,.429,20,40,.500,4,16,.250,14,17,.824,12,13,25,9,9,3,12,22,66,False,3335,Nebraska
10,School Totals,200,18,45,.400,11,21,.524,7,24,.292,8,13,.615,8,22,30,14,2,6,18,12,51,False,3336,Nebraska
11,School Totals,200,24,47,.511,18,33,.545,6,14,.429,15,18,.833,6,23,29,12,3,3,11,17,69,False,3337,Nebraska
11,School Totals,200,21,53,.396,17,37,.459,4,16,.250,14,19,.737,15,16,31,13,5,3,11,15,60,False,3338,Nebraska
11,School Totals,200,23,46,.500,17,28,.607,6,18,.333,20,26,.769,11,16,27,17,8,2,14,17,72,False,3339,Nebraska
11,School Totals,200,15,49,.306,12,36,.333,3,13,.231,7,9,.778,9,16,25,9,5,1,9,10,40,False,3340,Nebraska
11,School Totals,200,18,50,.360,11,25,.440,7,25,.280,12,15,.800,6,15,21,12,7,1,12,18,55,False,1249,Nebraska
11,School Totals,200,16,52,.308,14,34,.412,2,18,.111,6,6,1.000,4,14,18,7,13,0,16,15,40,False,1614,Nebraska
11,School Totals,200,18,36,.500,13,22,.591,5,14,.357,13,19,.684,3,21,24,8,5,3,20,18,54,False,2552,Nebraska
8,School Totals,200,22,40,.550,15,21,.714,7,19,.368,19,29,.655,4,25,29,14,8,6,16,14,70,False,1938,Nebraska
10,School Totals,200,19,54,.352,14,35,.400,5,19,.263,2,2,1.000,7,18,25,7,7,2,6,19,45,False,3341,Nebraska
8,School Totals,200,23,61,.377,13,31,.419,10,30,.333,14,19,.737,9,20,29,15,8,3,9,15,70,False,81,Nebraska
13,School Totals,200,13,44,.295,10,27,.370,3,17,.176,16,23,.696,10,26,36,8,5,3,27,25,45,False,1617,Nebraska
9,School Totals,200,27,52,.519,20,32,.625,7,20,.350,18,24,.750,10,19,29,15,6,1,9,15,79,False,2824,Nebraska
10,School Totals,200,28,54,.519,17,28,.607,11,26,.423,7,9,.778,8,18,26,19,6,2,13,18,74,False,3342,Nebraska
9,School Totals,200,21,48,.438,14,27,.519,7,21,.333,12,13,.923,8,13,21,10,9,4,13,18,61,False,3078,Nebraska
12,School Totals,200,18,46,.391,13,28,.464,5,18,.278,5,6,.833,8,19,27,7,3,1,13,8,46,False,869,Nebraska
12,School Totals,200,19,48,.396,13,28,.464,6,20,.300,7,11,.636,4,16,20,11,7,2,10,14,51,False,1943,Nebraska
14,School Totals,200,30,54,.556,20,34,.588,10,20,.500,10,15,.667,3,27,30,19,8,1,10,16,80,False,2557,Nebraska
11,School Totals,200,27,52,.519,19,33,.576,8,19,.421,3,3,1.000,2,18,20,17,3,1,10,15,65,False,3343,Nebraska
12,School Totals,200,14,48,.292,12,31,.387,2,17,.118,4,5,.800,4,14,18,8,9,0,11,14,34,False,1261,Nebraska
9,School Totals,200,19,52,.365,15,28,.536,4,24,.167,11,13,.846,8,20,28,15,8,3,11,17,53,False,2828,Nebraska
9,School Totals,200,22,55,.400,9,24,.375,13,31,.419,12,12,1.000,7,17,24,18,9,1,11,20,69,False,3082,Nebraska
13,School Totals,200,22,53,.415,14,26,.538,8,27,.296,9,10,.900,7,15,22,13,6,1,8,12,61,False,3344,Nebraska
11,School Totals,200,28,54,.519,25,44,.568,3,10,.300,7,10,.700,6,25,31,6,2,1,10,17,66,False,3345,Nebraska
11,School Totals,200,19,51,.373,14,39,.359,5,12,.417,7,11,.636,5,24,29,12,1,5,12,20,50,False,3346,Nebraska
10,School Totals,200,32,69,.464,29,47,.617,3,22,.136,8,9,.889,15,20,35,14,6,1,9,18,75,False,3347,Nebraska
9,School Totals,200,20,40,.500,10,21,.476,10,19,.526,11,19,.579,2,21,23,15,5,6,11,19,61,False,3348,Nebraska
9,School Totals,200,20,51,.392,17,32,.531,3,19,.158,17,26,.654,14,17,31,6,3,3,9,18,60,False,3349,Nebraska
9,School Totals,200,29,57,.509,25,45,.556,4,12,.333,17,24,.708,10,23,33,12,7,4,8,17,79,False,3350,Nebraska
9,School Totals,200,22,50,.440,11,33,.333,11,17,.647,8,11,.727,6,18,24,12,6,6,14,14,63,False,3351,Nebraska
12,School Totals,200,18,56,.321,14,40,.350,4,16,.250,2,6,.333,7,22,29,9,3,5,12,17,42,False,3352,Nebraska
10,School Totals,200,15,49,.306,12,32,.375,3,17,.176,5,7,.714,4,17,21,7,9,0,16,18,38,False,3353,Nebraska
9,School Totals,200,21,46,.457,21,41,.512,0,5,.000,17,21,.810,8,25,33,12,5,3,12,16,59,False,3354,Nebraska
10,School Totals,200,32,56,.571,23,38,.605,9,18,.500,16,22,.727,6,24,30,17,5,3,12,25,89,False,3355,Nebraska
9,School Totals,200,19,51,.373,17,38,.447,2,13,.154,12,17,.706,7,22,29,11,4,1,10,16,52,False,3356,Nebraska
10,School Totals,200,22,48,.458,18,36,.500,4,12,.333,20,33,.606,8,24,32,11,5,2,7,18,68,False,3357,Nebraska
9,School Totals,200,17,56,.304,11,35,.314,6,21,.286,4,8,.500,5,24,29,6,3,2,14,10,44,False,1643,Nebraska
9,School Totals,200,18,49,.367,16,37,.432,2,12,.167,3,5,.600,2,26,28,4,4,4,8,15,41,False,3358,Nebraska
8,School Totals,200,19,56,.339,13,30,.433,6,26,.231,3,7,.429,7,21,28,10,3,3,5,18,47,False,894,Nebraska
9,School Totals,200,23,58,.397,18,39,.462,5,19,.263,5,8,.625,8,21,29,13,8,5,12,18,56,False,1285,Nebraska
8,School Totals,200,22,66,.333,19,56,.339,3,10,.300,9,12,.750,13,21,34,7,8,3,2,14,56,False,3359,Nebraska
9,School Totals,200,24,51,.471,20,38,.526,4,13,.308,16,16,1.000,4,22,26,12,8,4,10,20,68,False,1963,Nebraska
13,School Totals,200,14,44,.318,12,30,.400,2,14,.143,21,30,.700,9,18,27,5,6,2,14,18,51,False,2579,Nebraska
12,School Totals,200,23,51,.451,17,33,.515,6,18,.333,12,23,.522,10,29,39,10,8,4,11,17,64,False,3360,Nebraska
10,School Totals,200,24,44,.545,15,30,.500,9,14,.643,8,15,.533,4,13,17,13,2,0,11,17,65,False,3105,Nebraska
8,School Totals,200,23,62,.371,17,36,.472,6,26,.231,4,5,.800,13,21,34,8,5,5,9,17,56,False,1649,Nebraska
10,School Totals,200,15,46,.326,10,28,.357,5,18,.278,32,41,.780,9,25,34,11,5,6,8,23,67,False,1966,Nebraska
13,School Totals,200,17,47,.362,13,31,.419,4,16,.250,9,11,.818,8,13,21,3,4,1,15,22,47,False,123,Nebraska
9,School Totals,200,22,62,.355,14,38,.368,8,24,.333,12,13,.923,11,12,23,9,7,1,7,20,64,False,1292,Nebraska
9,School Totals,200,26,56,.464,21,41,.512,5,15,.333,7,14,.500,8,19,27,7,5,3,10,13,64,False,2852,Nebraska
12,School Totals,200,20,61,.328,17,50,.340,3,11,.273,3,5,.600,6,23,29,6,4,0,10,16,46,False,3361,Nebraska
8,School Totals,200,25,55,.455,16,37,.432,9,18,.500,6,9,.667,6,16,22,11,4,5,9,14,65,False,2584,Nebraska
9,School Totals,200,16,45,.356,11,30,.367,5,15,.333,16,20,.800,7,21,28,11,4,5,8,22,53,False,3107,Nebraska
13,School Totals,200,21,56,.375,11,31,.355,10,25,.400,8,11,.727,9,7,16,11,6,3,5,17,60,False,2854,Nebraska
9,School Totals,200,21,47,.447,18,36,.500,3,11,.273,12,17,.706,3,25,28,15,7,4,6,14,57,False,3362,Nebraska
12,School Totals,200,21,51,.412,18,32,.563,3,19,.158,5,8,.625,8,17,25,9,5,3,15,13,50,False,1655,Nebraska
11,School Totals,200,25,48,.521,20,38,.526,5,10,.500,24,31,.774,5,23,28,6,7,1,8,22,79,False,3363,Nebraska
11,School Totals,200,22,50,.440,17,37,.459,5,13,.385,13,22,.591,7,22,29,6,7,1,8,16,62,False,3364,Nebraska
13,School Totals,200,26,56,.464,18,36,.500,8,20,.400,23,32,.719,10,25,35,11,5,4,5,20,83,False,3365,Nebraska
11,School Totals,200,28,66,.424,23,50,.460,5,16,.313,29,39,.744,16,16,32,6,10,5,13,34,90,False,3366,Nebraska
10,School Totals,200,28,65,.431,22,45,.489,6,20,.300,12,18,.667,7,15,22,7,9,1,6,24,74,False,3367,Nebraska
10,School Totals,200,23,52,.442,18,40,.450,5,12,.417,22,27,.815,9,20,29,10,6,7,7,25,73,False,3368,Nebraska
10,School Totals,200,20,50,.400,17,35,.486,3,15,.200,20,33,.606,11,26,37,10,10,6,16,22,63,False,3369,Nebraska
9,School Totals,200,18,46,.391,11,26,.423,7,20,.350,17,22,.773,6,27,33,12,10,5,11,16,60,False,3370,Nebraska
10,School Totals,200,22,52,.423,17,33,.515,5,19,.263,18,26,.692,5,23,28,13,4,2,9,23,67,False,3371,Nebraska
12,School Totals,200,29,60,.483,21,44,.477,8,16,.500,13,18,.722,8,26,34,19,15,1,16,21,79,False,3372,Nebraska
10,School Totals,200,25,48,.521,20,31,.645,5,17,.294,22,34,.647,7,21,28,12,9,3,13,16,77,False,3373,Nebraska
9,School Totals,200,20,56,.357,11,36,.306,9,20,.450,10,11,.909,9,16,25,12,4,4,11,23,59,False,3374,Nebraska
10,School Totals,200,20,67,.299,15,49,.306,5,18,.278,12,18,.667,15,25,40,9,10,1,11,28,57,False,2873,Nebraska
13,School Totals,200,21,56,.375,17,41,.415,4,15,.267,7,12,.583,8,21,29,7,3,1,11,23,53,False,1674,Nebraska
9,School Totals,199,26,49,.531,19,29,.655,7,20,.350,11,12,.917,8,17,25,10,5,2,13,12,70,False,930,Nebraska
9,School Totals,200,24,58,.414,20,42,.476,4,16,.250,12,18,.667,7,25,32,12,6,5,9,19,64,False,3375,Nebraska
11,School Totals,200,23,46,.500,21,33,.636,2,13,.154,20,26,.769,4,27,31,6,8,2,17,18,68,False,1677,Nebraska
11,School Totals,200,19,53,.358,9,30,.300,10,23,.435,6,10,.600,8,27,35,10,3,3,12,17,54,False,1988,Nebraska
9,School Totals,200,25,50,.500,14,28,.500,11,22,.500,21,33,.636,6,25,31,19,8,3,11,20,82,False,3126,Nebraska
11,School Totals,200,19,44,.432,11,25,.440,8,19,.421,14,19,.737,5,16,21,10,7,2,14,15,60,False,155,Nebraska
14,School Totals,200,19,54,.352,14,33,.424,5,21,.238,7,11,.636,7,17,24,7,7,1,11,14,50,False,936,Nebraska
10,School Totals,200,19,47,.404,12,27,.444,7,20,.350,8,14,.571,4,21,25,9,7,2,12,15,53,False,3376,Nebraska
10,School Totals,200,19,43,.442,14,28,.500,5,15,.333,24,27,.889,4,19,23,7,6,4,10,23,67,False,2607,Nebraska
9,School Totals,200,19,53,.358,10,23,.435,9,30,.300,13,21,.619,9,25,34,10,7,2,5,18,60,False,1323,Nebraska
14,School Totals,201,19,43,.442,14,28,.500,5,15,.333,37,48,.771,8,25,33,5,4,6,13,24,80,False,1992,Nebraska
14,School Totals,200,26,56,.464,20,36,.556,6,20,.300,18,27,.667,4,31,35,13,10,5,9,26,76,False,3377,Nebraska
10,School Totals,200,20,45,.444,17,32,.531,3,13,.231,6,7,.857,3,25,28,7,3,4,15,19,49,False,2609,Nebraska
10,School Totals,200,19,52,.365,15,35,.429,4,17,.235,12,17,.706,12,26,38,8,4,3,10,16,54,False,3378,Nebraska
9,School Totals,200,25,55,.455,19,38,.500,6,17,.353,14,19,.737,8,25,33,6,6,2,9,17,70,False,164,Nebraska
9,School Totals,200,26,50,.520,20,39,.513,6,11,.545,19,25,.760,1,24,25,9,6,2,5,17,77,False,3379,Nebraska
10,School Totals,200,22,60,.367,16,40,.400,6,20,.300,17,20,.850,8,23,31,9,7,2,9,26,67,False,1688,Nebraska
10,School Totals,200,23,54,.426,19,33,.576,4,21,.190,10,16,.625,5,19,24,7,9,7,11,29,60,False,3380,Nebraska
13,School Totals,200,23,48,.479,15,26,.577,8,22,.364,26,30,.867,6,25,31,10,6,7,10,22,80,False,3381,Nebraska
13,School Totals,200,27,51,.529,22,35,.629,5,16,.313,23,34,.676,9,27,36,12,8,5,15,15,82,False,3382,Nebraska
9,School Totals,225,21,57,.368,18,37,.486,3,20,.150,17,22,.773,6,24,30,10,6,6,16,23,62,False,3383,Nebraska
13,School Totals,200,28,53,.528,22,34,.647,6,19,.316,18,31,.581,10,27,37,14,11,3,19,21,80,False,3384,Nebraska
9,School Totals,200,26,55,.473,16,32,.500,10,23,.435,13,16,.813,8,21,29,13,3,3,16,12,75,False,3385,Nebraska
10,School Totals,200,24,58,.414,17,39,.436,7,19,.368,15,19,.789,7,20,27,12,7,1,13,28,70,False,3386,Nebraska
9,School Totals,200,23,61,.377,17,38,.447,6,23,.261,3,8,.375,14,18,32,14,4,3,11,17,55,False,3387,Nebraska
10,School Totals,200,22,52,.423,17,35,.486,5,17,.294,24,32,.750,10,23,33,13,6,1,14,20,73,False,3388,Nebraska
8,School Totals,250,16,49,.327,12,32,.375,4,17,.235,20,23,.870,8,34,42,3,5,4,22,21,56,False,3389,Nebraska
10,School Totals,200,20,46,.435,15,30,.500,5,16,.313,13,23,.565,11,23,34,7,6,4,18,22,58,False,3390,Nebraska
8,School Totals,225,14,38,.368,8,21,.381,6,17,.353,16,19,.842,2,19,21,8,7,2,13,13,50,False,3391,Nebraska
8,School Totals,200,23,51,.451,19,36,.528,4,15,.267,21,27,.778,7,30,37,9,10,4,11,16,71,False,3392,Nebraska
9,School Totals,200,23,59,.390,16,41,.390,7,18,.389,12,17,.706,5,24,29,11,7,5,7,17,65,False,180,Nebraska
10,School Totals,200,22,48,.458,20,34,.588,2,14,.143,13,21,.619,6,19,25,5,3,3,10,24,59,False,2896,Nebraska
12,School Totals,200,27,55,.491,22,40,.550,5,15,.333,6,13,.462,11,18,29,14,8,4,8,20,65,False,2347,Nebraska
9,School Totals,200,21,49,.429,15,32,.469,6,17,.353,5,5,1.000,4,31,35,10,5,4,12,10,53,False,2626,Nebraska
12,School Totals,200,21,50,.420,16,33,.485,5,17,.294,8,14,.571,6,15,21,9,5,0,5,18,55,False,3393,Nebraska
10,School Totals,200,17,42,.405,13,23,.565,4,19,.211,14,21,.667,3,33,36,12,6,1,14,21,52,False,3151,Nebraska
9,School Totals,200,22,45,.489,16,28,.571,6,17,.353,29,37,.784,5,21,26,6,7,2,9,22,79,False,1350,Nebraska
11,School Totals,200,15,49,.306,11,30,.367,4,19,.211,10,14,.714,8,18,26,6,3,2,10,12,44,False,971,Nebraska
14,School Totals,200,17,46,.370,13,26,.500,4,20,.200,4,5,.800,8,20,28,14,5,5,18,16,42,False,3152,Nebraska
10,School Totals,200,27,43,.628,17,22,.773,10,21,.476,12,15,.800,5,19,24,17,5,1,12,13,76,False,3394,Nebraska
13,School Totals,200,15,51,.294,13,31,.419,2,20,.100,11,15,.733,3,20,23,7,12,1,10,16,43,False,2018,Nebraska
10,School Totals,200,22,62,.355,18,44,.409,4,18,.222,7,10,.700,11,22,33,5,6,5,8,25,55,False,3395,Nebraska
10,School Totals,200,22,55,.400,19,39,.487,3,16,.188,7,9,.778,6,18,24,11,6,3,11,22,54,False,3396,Nebraska
10,School Totals,200,26,59,.441,16,33,.485,10,26,.385,3,7,.429,8,23,31,15,4,0,12,21,65,False,586,Nebraska
13,School Totals,200,17,52,.327,15,34,.441,2,18,.111,10,14,.714,8,19,27,8,7,5,13,14,46,False,2903,Nebraska
13,School Totals,200,22,51,.431,16,32,.500,6,19,.316,7,14,.500,9,18,27,10,5,2,12,18,57,False,1711,Nebraska
9,School Totals,200,24,56,.429,19,36,.528,5,20,.250,4,5,.800,8,19,27,14,3,2,9,19,57,False,2633,Nebraska
11,School Totals,200,18,59,.305,16,45,.356,2,14,.143,23,37,.622,12,21,33,5,10,0,7,23,61,False,590,Nebraska
10,School Totals,200,19,63,.302,14,49,.286,5,14,.357,22,31,.710,17,26,43,11,6,2,14,19,65,False,2023,Nebraska
15,School Totals,200,31,57,.544,21,35,.600,10,22,.455,25,34,.735,11,31,42,17,11,3,15,21,97,False,3397,Nebraska
13,School Totals,200,23,61,.377,16,38,.421,7,23,.304,10,13,.769,11,21,32,9,7,2,22,21,63,False,3398,Nebraska
11,School Totals,200,22,50,.440,10,22,.455,12,28,.429,19,25,.760,14,17,31,19,7,4,16,22,75,False,3399,Nebraska
15,School Totals,200,32,69,.464,26,56,.464,6,13,.462,22,32,.688,17,33,50,14,4,3,14,22,92,False,3400,Nebraska
15,School Totals,200,21,55,.382,19,36,.528,2,19,.105,23,32,.719,14,31,45,10,5,4,11,21,67,False,3401,Nebraska
11,School Totals,200,22,52,.423,15,36,.417,7,16,.438,10,11,.909,5,21,26,12,9,4,12,20,61,False,3402,Nebraska
12,School Totals,200,30,61,.492,24,48,.500,6,13,.462,16,27,.593,10,29,39,11,8,0,13,19,82,False,3403,Nebraska
10,School Totals,225,27,64,.422,18,46,.391,9,18,.500,9,12,.750,8,25,33,10,7,4,11,22,72,False,3404,Nebraska
12,School Totals,200,21,49,.429,17,33,.515,4,16,.250,27,36,.750,11,21,32,10,12,5,12,18,73,False,3405,Nebraska
11,School Totals,200,27,68,.397,23,47,.489,4,21,.190,9,13,.692,9,27,36,11,8,5,14,26,67,False,3406,Nebraska
11,School Totals,200,22,43,.512,16,35,.457,6,8,.750,20,24,.833,4,20,24,12,7,4,16,12,70,False,3407,Nebraska
11,School Totals,200,21,48,.438,15,26,.577,6,22,.273,10,20,.500,9,27,36,10,7,3,16,22,58,False,3408,Nebraska
14,School Totals,200,28,56,.500,24,42,.571,4,14,.286,21,29,.724,11,25,36,17,9,0,12,18,81,False,3409,Nebraska
10,School Totals,200,27,60,.450,16,34,.471,11,26,.423,7,8,.875,8,17,25,18,3,3,6,16,72,False,3410,Nebraska
10,School Totals,200,24,55,.436,16,35,.457,8,20,.400,13,20,.650,5,24,29,11,8,4,14,24,69,False,215,Nebraska
11,School Totals,200,25,58,.431,18,38,.474,7,20,.350,9,16,.563,10,22,32,8,4,2,8,26,66,False,2920,Nebraska
15,School Totals,200,37,65,.569,30,47,.638,7,18,.389,9,14,.643,13,25,38,15,8,4,11,19,90,False,2369,Nebraska
15,School Totals,200,30,58,.517,25,40,.625,5,18,.278,19,24,.792,14,23,37,17,9,4,13,19,84,False,3170,Nebraska
9,School Totals,200,30,56,.536,24,43,.558,6,13,.462,12,18,.667,8,33,41,10,2,4,10,15,78,False,2650,Nebraska
9,School Totals,200,29,58,.500,25,44,.568,4,14,.286,10,14,.714,4,27,31,8,7,0,6,17,72,False,1385,Nebraska
10,School Totals,200,28,58,.483,22,36,.611,6,22,.273,6,9,.667,8,16,24,11,9,3,10,18,68,False,999,Nebraska
11,School Totals,200,28,62,.452,21,41,.512,7,21,.333,11,13,.846,3,14,17,12,10,3,9,23,74,False,3411,Nebraska
10,School Totals,200,21,66,.318,14,43,.326,7,23,.304,16,22,.727,13,18,31,6,9,1,6,18,65,False,616,Nebraska
14,School Totals,200,34,67,.507,26,45,.578,8,22,.364,11,12,.917,9,28,37,22,9,3,10,13,87,False,2373,Nebraska
10,School Totals,200,24,59,.407,20,46,.435,4,13,.308,9,12,.750,12,19,31,7,3,4,10,23,61,False,3412,Nebraska
13,School Totals,200,25,54,.463,17,36,.472,8,18,.444,12,13,.923,10,20,30,10,11,3,12,13,70,False,2044,Nebraska
10,School Totals,200,26,53,.491,20,38,.526,6,15,.400,6,10,.600,4,20,24,12,5,3,11,19,64,False,227,Nebraska
10,School Totals,225,19,70,.271,10,35,.286,9,35,.257,15,23,.652,18,20,38,10,6,6,9,23,62,False,1741,Nebraska
10,School Totals,200,19,47,.404,14,33,.424,5,14,.357,12,17,.706,8,20,28,9,8,4,12,12,55,False,2047,Nebraska
11,School Totals,200,24,60,.400,21,47,.447,3,13,.231,11,15,.733,7,18,25,7,3,1,7,18,62,False,3413,Nebraska
10,School Totals,200,19,52,.365,13,31,.419,6,21,.286,10,13,.769,6,17,23,11,9,5,12,18,54,False,3414,Nebraska
13,School Totals,200,33,70,.471,26,54,.481,7,16,.438,16,21,.762,15,24,39,18,11,2,10,17,89,False,2378,Nebraska
10,School Totals,200,23,49,.469,21,41,.512,2,8,.250,22,28,.786,4,31,35,4,9,7,13,22,70,False,3415,Nebraska
11,School Totals,200,31,66,.470,20,35,.571,11,31,.355,13,14,.929,10,17,27,9,6,5,8,19,86,False,624,Nebraska
11,School Totals,200,31,65,.477,25,54,.463,6,11,.545,15,18,.833,11,30,41,13,5,3,11,17,83,False,3416,Nebraska
11,School Totals,200,26,52,.500,18,29,.621,8,23,.348,10,12,.833,10,33,43,16,3,7,16,15,70,False,3417,Nebraska
11,School Totals,200,19,51,.373,13,33,.394,6,18,.333,21,24,.875,7,25,32,8,6,5,11,15,65,False,3418,Nebraska
11,School Totals,200,29,51,.569,23,35,.657,6,16,.375,16,24,.667,6,23,29,11,5,5,14,22,80,False,3419,Nebraska
12,School Totals,200,29,75,.387,23,51,.451,6,24,.250,7,13,.538,14,23,37,11,3,2,5,18,71,False,3420,Nebraska
12,School Totals,200,17,57,.298,13,36,.361,4,21,.190,15,18,.833,12,23,35,8,9,4,14,20,53,False,3421,Nebraska
10,School Totals,200,25,63,.397,21,45,.467,4,18,.222,4,7,.571,14,24,38,6,9,5,16,20,58,False,3422,Nebraska
11,School Totals,200,25,59,.424,16,36,.444,9,23,.391,14,16,.875,7,31,38,19,8,4,15,12,73,False,3423,Nebraska
11,School Totals,200,23,71,.324,20,49,.408,3,22,.136,13,16,.813,15,23,38,8,6,4,12,22,62,False,3424,Nebraska
12,School Totals,200,27,69,.391,24,62,.387,3,7,.429,15,18,.833,16,19,35,12,8,3,12,17,72,False,3425,Nebraska
11,School Totals,200,22,56,.393,19,39,.487,3,17,.176,15,26,.577,17,28,45,13,4,6,20,21,62,False,3426,Nebraska
11,School Totals,200,27,56,.482,20,34,.588,7,22,.318,20,30,.667,12,19,31,12,8,5,12,15,81,False,3427,Nebraska
9,School Totals,200,31,64,.484,22,46,.478,9,18,.500,16,22,.727,15,21,36,12,13,7,13,19,87,False,248,Nebraska
10,School Totals,200,24,57,.421,20,45,.444,4,12,.333,15,23,.652,13,28,41,10,11,5,15,24,67,False,643,Nebraska
10,School Totals,250,32,70,.457,22,47,.468,10,23,.435,19,35,.543,12,26,38,18,14,7,12,18,93,False,2941,Nebraska
10,School Totals,200,25,58,.431,19,42,.452,6,16,.375,10,13,.769,11,18,29,12,6,3,9,13,66,False,3428,Nebraska
10,School Totals,200,36,64,.563,27,46,.587,9,18,.500,4,5,.800,9,17,26,9,7,3,12,23,85,False,1029,Nebraska
10,School Totals,200,25,60,.417,20,39,.513,5,21,.238,11,20,.550,8,28,36,10,6,4,7,16,66,False,1763,Nebraska
10,School Totals,200,24,69,.348,16,45,.356,8,24,.333,8,9,.889,11,19,30,12,8,4,10,18,64,False,2395,Nebraska
9,School Totals,200,23,63,.365,20,48,.417,3,15,.200,12,19,.632,10,26,36,12,6,4,12,19,61,False,3429,Nebraska
9,School Totals,200,28,65,.431,19,48,.396,9,17,.529,18,24,.750,13,24,37,13,4,4,9,16,83,False,3430,Nebraska
10,School Totals,200,20,52,.385,16,36,.444,4,16,.250,17,22,.773,12,20,32,6,7,3,13,17,61,False,1417,Nebraska
10,School Totals,200,27,64,.422,24,44,.545,3,20,.150,13,16,.813,14,24,38,11,5,1,14,24,70,False,2944,Nebraska
10,School Totals,225,24,60,.400,18,46,.391,6,14,.429,15,24,.625,20,30,50,13,8,4,22,22,69,False,3431,Nebraska
15,School Totals,200,31,56,.554,26,39,.667,5,17,.294,15,20,.750,6,30,36,18,6,3,12,18,82,False,2071,Nebraska
10,School Totals,200,23,60,.383,15,41,.366,8,19,.421,4,9,.444,7,22,29,10,6,1,13,18,58,False,1768,Nebraska
12,School Totals,200,23,59,.390,18,46,.391,5,13,.385,21,28,.750,8,27,35,13,5,2,10,26,72,False,1421,Nebraska
12,School Totals,200,21,56,.375,17,41,.415,4,15,.267,11,13,.846,11,21,32,10,6,0,18,16,57,False,2680,Nebraska
12,School Totals,200,29,77,.377,23,56,.411,6,21,.286,9,12,.750,17,23,40,10,6,5,16,18,73,False,3190,Nebraska
14,School Totals,200,21,51,.412,19,36,.528,2,15,.133,13,22,.591,10,13,23,11,6,0,16,14,57,False,1040,Nebraska
10,School Totals,225,26,76,.342,18,52,.346,8,24,.333,7,10,.700,10,23,33,7,7,3,7,24,67,False,2075,Nebraska
11,School Totals,200,22,57,.386,17,41,.415,5,16,.313,23,39,.590,14,26,40,11,6,9,12,16,72,False,3432,Nebraska
15,School Totals,200,24,60,.400,19,43,.442,5,17,.294,33,45,.733,19,26,45,12,7,9,12,22,86,False,3433,Nebraska
15,School Totals,200,16,57,.281,10,31,.323,6,26,.231,18,24,.750,9,25,34,9,4,5,16,20,56,False,3434,Nebraska
15,School Totals,200,36,68,.529,28,48,.583,8,20,.400,12,18,.667,12,29,41,20,8,5,13,22,92,False,3435,Nebraska
12,School Totals,200,21,61,.344,15,40,.375,6,21,.286,11,13,.846,12,19,31,13,8,5,13,24,59,False,3436,Nebraska
16,School Totals,200,34,60,.567,23,36,.639,11,24,.458,5,8,.625,10,22,32,23,7,6,8,15,84,False,3437,Nebraska
12,School Totals,200,32,67,.478,25,51,.490,7,16,.438,14,18,.778,10,15,25,21,15,7,12,18,85,False,3438,Nebraska
10,School Totals,200,27,55,.491,18,36,.500,9,19,.474,8,15,.533,8,23,31,16,9,3,7,14,71,False,3439,Nebraska
14,School Totals,200,17,62,.274,7,40,.175,10,22,.455,13,20,.650,10,24,34,10,0,1,5,25,57,False,1435,Nebraska
10,School Totals,200,25,53,.472,19,32,.594,6,21,.286,22,28,.786,9,30,39,11,5,9,16,19,78,False,3201,Nebraska
11,School Totals,200,27,71,.380,18,45,.400,9,26,.346,2,3,.667,9,20,29,16,7,3,7,20,65,False,3440,Nebraska
10,School Totals,200,29,59,.492,21,37,.568,8,22,.364,6,8,.750,7,24,31,14,3,7,14,15,72,False,3441,Nebraska
11,School Totals,200,28,55,.509,17,31,.548,11,24,.458,37,50,.740,13,28,41,14,5,2,7,12,104,False,3442,Nebraska
16,School Totals,200,31,60,.517,18,33,.545,13,27,.481,10,17,.588,11,20,31,24,7,6,13,11,85,False,3443,Nebraska
11,School Totals,200,22,63,.349,17,42,.405,5,21,.238,22,34,.647,14,37,51,13,4,9,11,13,71,False,3444,Nebraska
11,School Totals,200,24,55,.436,17,39,.436,7,16,.438,15,17,.882,9,24,33,14,7,14,10,17,70,False,3445,Nebraska
11,School Totals,200,22,54,.407,16,37,.432,6,17,.353,12,16,.750,4,23,27,12,10,1,15,19,62,False,3446,Nebraska
11,School Totals,200,20,47,.426,18,33,.545,2,14,.143,21,28,.750,6,28,34,8,2,6,13,17,63,False,3447,Nebraska
11,School Totals,225,25,68,.368,16,42,.381,9,26,.346,15,24,.625,10,25,35,12,7,6,6,17,74,False,2092,Nebraska
10,School Totals,200,21,51,.412,16,28,.571,5,23,.217,17,23,.739,5,22,27,11,9,5,10,20,64,False,2700,Nebraska
15,School Totals,200,26,47,.553,21,36,.583,5,11,.455,15,23,.652,7,21,28,12,9,4,9,14,72,False,1066,Nebraska
11,School Totals,200,21,54,.389,13,25,.520,8,29,.276,9,11,.818,7,23,30,6,3,3,9,20,59,False,1790,Nebraska
10,School Totals,200,21,53,.396,16,35,.457,5,18,.278,13,16,.813,9,21,30,10,8,6,16,15,60,False,2420,Nebraska
9,School Totals,200,30,52,.577,19,33,.576,11,19,.579,27,36,.750,11,25,36,18,5,4,11,14,98,False,2964,Nebraska
11,School Totals,200,23,56,.411,19,37,.514,4,19,.211,24,28,.857,3,28,31,10,6,4,6,26,74,False,3448,Nebraska
9,School Totals,200,31,61,.508,20,38,.526,11,23,.478,18,22,.818,10,25,35,19,2,5,8,17,91,False,3210,Nebraska
15,School Totals,200,25,55,.455,22,40,.550,3,15,.200,14,19,.737,11,27,38,14,6,8,11,10,67,False,2423,Nebraska
10,School Totals,200,25,55,.455,18,36,.500,7,19,.368,13,19,.684,10,25,35,14,4,6,10,15,70,False,687,Nebraska
9,School Totals,200,23,53,.434,13,27,.481,10,26,.385,10,18,.556,4,23,27,13,3,6,9,15,66,False,2703,Nebraska
9,School Totals,200,25,62,.403,19,40,.475,6,22,.273,10,17,.588,17,18,35,15,9,4,13,13,66,False,298,Nebraska
11,School Totals,200,28,57,.491,24,44,.545,4,13,.308,16,23,.696,12,29,41,16,6,3,13,14,76,False,2099,Nebraska
13,School Totals,200,16,53,.302,12,37,.324,4,16,.250,22,27,.815,6,21,27,5,3,8,10,18,58,False,1077,Nebraska
10,School Totals,200,23,65,.354,17,43,.395,6,22,.273,7,9,.778,9,18,27,10,6,4,5,18,59,False,3449,Nebraska
13,School Totals,200,38,69,.551,23,32,.719,15,37,.405,15,24,.625,13,40,53,23,10,8,10,15,106,False,3450,Nebraska
13,School Totals,200,31,55,.564,23,30,.767,8,25,.320,17,22,.773,6,30,36,21,14,8,15,14,87,False,3451,Nebraska
10,School Totals,200,26,63,.413,18,40,.450,8,23,.348,20,27,.741,14,27,41,15,7,6,8,16,80,False,3452,Nebraska
13,School Totals,200,31,61,.508,18,28,.643,13,33,.394,10,16,.625,7,26,33,21,9,6,10,11,85,False,3453,Nebraska
9,School Totals,200,17,48,.354,12,25,.480,5,23,.217,13,21,.619,5,20,25,6,6,3,14,16,52,False,3454,Nebraska
11,School Totals,200,29,63,.460,25,43,.581,4,20,.200,11,19,.579,9,35,44,12,8,7,9,9,73,False,3455,Nebraska
10,School Totals,200,26,55,.473,19,33,.576,7,22,.318,9,11,.818,9,19,28,10,5,3,9,13,68,False,3456,Nebraska
10,School Totals,200,22,46,.478,16,32,.500,6,14,.429,25,30,.833,6,24,30,13,8,3,16,16,75,False,2713,Nebraska
10,School Totals,200,28,61,.459,21,40,.525,7,21,.333,15,19,.789,12,16,28,13,8,5,10,22,78,False,3220,Nebraska
12,School Totals,200,32,60,.533,18,33,.545,14,27,.519,16,20,.800,11,24,35,15,9,5,9,15,94,False,3457,Nebraska
12,School Totals,200,25,53,.472,17,35,.486,8,18,.444,21,23,.913,5,19,24,13,10,5,11,13,79,False,3458,Nebraska
12,School Totals,200,26,59,.441,16,37,.432,10,22,.455,24,38,.632,7,26,33,18,6,4,7,11,86,False,3459,Nebraska
11,School Totals,200,29,66,.439,18,42,.429,11,24,.458,10,11,.909,11,32,43,15,12,1,6,10,79,False,3460,Nebraska
9,School Totals,200,24,51,.471,15,29,.517,9,22,.409,15,23,.652,6,21,27,11,7,4,10,17,72,False,705,Nebraska
10,School Totals,200,30,65,.462,26,42,.619,4,23,.174,20,26,.769,8,20,28,17,8,3,7,25,84,False,2981,Nebraska
9,School Totals,200,27,55,.491,18,32,.563,9,23,.391,7,11,.636,6,25,31,13,7,8,7,13,70,False,2119,Nebraska
9,School Totals,200,27,60,.450,19,36,.528,8,24,.333,4,6,.667,7,27,34,13,7,3,12,18,66,False,317,Nebraska
10,School Totals,200,22,67,.328,17,41,.415,5,26,.192,15,19,.789,12,18,30,11,9,2,9,19,64,False,1474,Nebraska
9,School Totals,200,25,60,.417,16,38,.421,9,22,.409,10,18,.556,7,24,31,12,11,4,12,24,69,False,2442,Nebraska
11,School Totals,200,21,58,.362,13,36,.361,8,22,.364,10,12,.833,7,22,29,10,5,1,11,16,60,False,1816,Nebraska
12,School Totals,200,17,60,.283,13,40,.325,4,20,.200,13,20,.650,16,27,43,7,4,2,9,16,51,False,3461,Nebraska
10,School Totals,200,25,70,.357,22,47,.468,3,23,.130,11,21,.524,18,28,46,13,3,2,9,22,64,False,2723,Nebraska
9,School Totals,200,12,57,.211,8,40,.200,4,17,.235,17,26,.654,10,28,38,5,5,5,4,16,45,False,714,Nebraska
9,School Totals,200,21,55,.382,11,31,.355,10,24,.417,10,13,.769,6,16,22,13,2,4,8,17,62,False,3462,Nebraska
9,School Totals,200,24,48,.500,19,34,.559,5,14,.357,9,13,.692,2,20,22,11,3,4,11,14,62,False,3228,Nebraska
9,School Totals,200,21,64,.328,15,42,.357,6,22,.273,11,14,.786,12,25,37,13,8,7,8,9,59,False,3463,Nebraska
11,School Totals,200,28,59,.475,22,41,.537,6,18,.333,9,18,.500,10,16,26,10,5,2,11,17,71,False,2126,Nebraska
9,School Totals,200,25,61,.410,17,38,.447,8,23,.348,14,17,.824,9,20,29,14,3,5,4,21,72,False,3464,Nebraska
12,School Totals,200,23,67,.343,21,55,.382,2,12,.167,5,9,.556,10,20,30,6,8,3,5,12,53,False,1111,Nebraska
11,School Totals,200,26,62,.419,16,35,.457,10,27,.370,14,24,.583,11,19,30,11,5,2,9,17,76,False,1482,Nebraska
9,School Totals,225,35,68,.515,22,42,.524,13,26,.500,10,20,.500,8,32,40,18,7,7,9,25,93,False,2986,Nebraska
8,School Totals,200,21,52,.404,18,37,.486,3,15,.200,23,32,.719,5,17,22,9,12,4,9,13,68,False,2448,Nebraska
8,School Totals,200,24,55,.436,16,33,.485,8,22,.364,13,19,.684,8,25,33,12,8,4,7,21,69,False,722,Nebraska
7,School Totals,200,24,63,.381,16,35,.457,8,28,.286,6,8,.750,8,14,22,7,10,7,9,14,62,False,3465,Nebraska
7,School Totals,200,26,52,.500,21,36,.583,5,16,.313,23,27,.852,11,22,33,18,6,2,8,14,80,False,3466,Nebraska
8,School Totals,200,28,65,.431,21,43,.488,7,22,.318,9,17,.529,12,22,34,17,5,2,6,19,72,False,3467,Nebraska
12,School Totals,200,16,55,.291,10,29,.345,6,26,.231,9,19,.474,9,19,28,12,6,6,11,11,47,False,3468,Nebraska
10,School Totals,250,27,73,.370,22,47,.468,5,26,.192,19,29,.655,8,32,40,15,9,5,13,17,78,False,3469,Nebraska
12,School Totals,200,35,71,.493,28,45,.622,7,26,.269,13,23,.565,11,32,43,16,5,3,11,19,90,False,3470,Nebraska
10,School Totals,225,31,54,.574,19,33,.576,12,21,.571,19,37,.514,4,24,28,19,5,5,9,12,93,False,3471,Nebraska
10,School Totals,200,30,57,.526,21,39,.538,9,18,.500,13,25,.520,6,33,39,11,5,2,15,16,82,False,3472,Nebraska
11,School Totals,200,24,61,.393,14,31,.452,10,30,.333,8,13,.615,6,19,25,12,9,4,14,13,66,False,3473,Nebraska
10,School Totals,200,27,49,.551,21,35,.600,6,14,.429,14,19,.737,3,21,24,10,2,1,9,10,74,False,3474,Nebraska
12,School Totals,200,21,65,.323,15,39,.385,6,26,.231,8,18,.444,11,28,39,14,7,2,17,14,56,False,3475,Nebraska
11,School Totals,200,27,65,.415,18,38,.474,9,27,.333,13,24,.542,5,26,31,9,4,3,12,13,76,False,3476,Nebraska
10,School Totals,225,33,75,.440,21,43,.488,12,32,.375,12,18,.667,8,20,28,19,5,0,9,23,90,False,346,Nebraska
9,School Totals,200,26,61,.426,15,31,.484,11,30,.367,7,9,.778,4,35,39,22,6,2,10,9,70,False,3477,Nebraska
10,School Totals,200,28,59,.475,19,38,.500,9,21,.429,9,16,.563,10,21,31,14,8,1,11,14,74,False,3478,Nebraska
11,School Totals,200,23,66,.348,16,41,.390,7,25,.280,20,28,.714,12,33,45,13,15,4,12,15,73,False,3479,Nebraska
11,School Totals,200,20,63,.317,12,32,.375,8,31,.258,14,21,.667,13,15,28,15,7,2,7,11,62,False,2461,Nebraska
9,School Totals,200,26,53,.491,16,27,.593,10,26,.385,14,26,.538,4,27,31,16,7,1,11,14,76,False,3001,Nebraska
9,School Totals,200,21,67,.313,12,37,.324,9,30,.300,6,11,.545,7,31,38,14,7,2,6,14,57,False,3480,Nebraska
11,School Totals,200,28,66,.424,19,44,.432,9,22,.409,3,5,.600,9,17,26,15,2,3,8,15,68,False,1841,Nebraska
10,School Totals,200,25,63,.397,16,33,.485,9,30,.300,15,22,.682,5,21,26,16,8,1,11,18,74,False,353,Nebraska
10,School Totals,200,26,60,.433,20,38,.526,6,22,.273,10,15,.667,8,25,33,12,6,3,10,13,68,False,3481,Nebraska
9,School Totals,200,26,62,.419,15,34,.441,11,28,.393,9,13,.692,4,25,29,14,6,1,10,17,72,False,2465,Nebraska
10,School Totals,200,26,59,.441,17,38,.447,9,21,.429,7,12,.583,4,21,25,16,5,1,13,22,68,False,1138,Nebraska
11,School Totals,200,24,62,.387,16,41,.390,8,21,.381,8,19,.421,9,27,36,12,8,1,12,16,64,False,2147,Nebraska
11,School Totals,200,28,66,.424,23,41,.561,5,25,.200,11,14,.786,9,24,33,15,7,2,12,17,72,False,3005,Nebraska
10,School Totals,200,26,64,.406,19,31,.613,7,33,.212,11,15,.733,9,25,34,18,7,0,10,22,70,False,746,Nebraska
11,School Totals,200,25,65,.385,17,40,.425,8,25,.320,6,12,.500,8,26,34,15,7,2,10,12,64,False,3482,Nebraska
10,School Totals,200,23,66,.348,15,34,.441,8,32,.250,11,16,.688,7,17,24,15,11,6,10,15,65,False,1512,Nebraska
9,School Totals,200,24,57,.421,19,42,.452,5,15,.333,6,9,.667,5,29,34,8,7,2,13,14,59,False,2746,Nebraska
10,School Totals,200,21,59,.356,18,43,.419,3,16,.188,9,14,.643,6,22,28,8,5,4,11,16,54,False,1849,Nebraska
10,School Totals,225,28,66,.424,16,34,.471,12,32,.375,8,30,.267,11,28,39,15,16,4,21,17,76,False,3483,Nebraska
9,School Totals,200,21,58,.362,17,45,.378,4,13,.308,12,15,.800,8,29,37,8,8,2,22,17,58,False,1147,Nebraska
8,School Totals,200,28,74,.378,23,52,.442,5,22,.227,14,17,.824,11,16,27,12,5,0,11,12,75,False,3248,Nebraska
10,School Totals,200,21,70,.300,13,40,.325,8,30,.267,14,20,.700,9,26,35,12,8,4,11,17,64,False,367,Nebraska
12,School Totals,200,36,72,.500,26,48,.542,10,24,.417,20,29,.690,14,26,40,19,16,4,9,15,102,False,3484,Nebraska
9,School Totals,200,18,62,.290,9,21,.429,9,41,.220,21,30,.700,10,20,30,13,12,1,9,24,66,False,3485,Nebraska
12,School Totals,200,29,63,.460,20,31,.645,9,32,.281,12,20,.600,10,31,41,15,11,4,10,16,79,False,3486,Nebraska
9,School Totals,200,24,60,.400,17,36,.472,7,24,.292,21,30,.700,10,34,44,10,9,3,15,20,76,False,3487,Nebraska
9,School Totals,200,23,61,.377,15,38,.395,8,23,.348,10,15,.667,13,25,38,14,3,1,16,19,64,False,3488,Nebraska
12,School Totals,200,25,57,.439,14,31,.452,11,26,.423,13,22,.591,9,27,36,12,5,3,25,15,74,False,3489,Nebraska
12,School Totals,200,41,74,.554,29,41,.707,12,33,.364,16,25,.640,13,42,55,25,8,7,8,11,110,False,3490,Nebraska
12,School Totals,200,18,54,.333,10,27,.370,8,27,.296,9,17,.529,5,23,28,12,6,6,9,15,53,False,3491,Nebraska
11,School Totals,200,25,64,.391,18,44,.409,7,20,.350,12,20,.600,6,23,29,6,6,3,8,19,69,False,1154,Nebraska
12,School Totals,200,17,60,.283,12,27,.444,5,33,.152,15,21,.714,8,22,30,3,6,3,15,20,54,False,1860,Nebraska
11,School Totals,200,27,55,.491,18,36,.500,9,19,.474,14,19,.737,6,20,26,12,4,1,15,21,77,False,1525,Nebraska
10,School Totals,200,26,57,.456,17,34,.500,9,23,.391,15,22,.682,4,25,29,16,4,2,9,19,76,False,380,Nebraska
10,School Totals,200,21,58,.362,18,41,.439,3,17,.176,11,24,.458,6,23,29,11,12,6,17,17,56,False,1531,Nebraska
11,School Totals,200,21,57,.368,18,42,.429,3,15,.200,16,25,.640,8,29,37,12,6,5,18,22,61,False,3259,Nebraska
13,School Totals,200,18,49,.367,13,34,.382,5,15,.333,7,17,.412,8,32,40,13,5,2,17,19,48,False,3492,Nebraska
11,School Totals,225,24,65,.369,17,45,.378,7,20,.350,17,25,.680,12,24,36,12,7,5,11,20,72,False,2760,Nebraska
11,School Totals,200,27,56,.482,20,37,.541,7,19,.368,1,3,.333,3,28,31,19,7,6,16,12,62,False,2166,Nebraska
15,School Totals,200,18,54,.333,10,26,.385,8,28,.286,6,12,.500,2,24,26,8,13,2,11,16,50,False,774,Nebraska
14,School Totals,200,24,56,.429,11,28,.393,13,28,.464,10,12,.833,4,26,30,12,2,2,11,16,71,False,775,Nebraska
14,School Totals,200,22,63,.349,13,35,.371,9,28,.321,5,14,.357,8,27,35,14,5,4,11,13,58,False,3493,Nebraska
11,School Totals,200,30,56,.536,18,31,.581,12,25,.480,11,15,.733,2,26,28,16,7,3,18,19,83,False,2168,Nebraska
15,School Totals,200,27,61,.443,22,40,.550,5,21,.238,11,16,.688,3,22,25,8,4,2,14,25,70,False,2763,Nebraska
10,School Totals,200,30,55,.545,21,38,.553,9,17,.529,9,16,.563,7,30,37,19,7,5,18,21,78,False,3262,Nebraska
13,School Totals,200,28,54,.519,20,30,.667,8,24,.333,8,13,.615,7,30,37,19,11,1,13,10,72,False,2483,Nebraska
14,School Totals,200,22,65,.338,10,29,.345,12,36,.333,8,10,.800,8,28,36,14,3,2,20,11,64,False,3021,Nebraska
10,School Totals,200,26,56,.464,12,23,.522,14,33,.424,12,16,.750,7,22,29,21,6,1,13,15,78,False,3494,Nebraska
9,School Totals,200,24,60,.400,15,27,.556,9,33,.273,9,11,.818,6,19,25,14,8,4,14,23,66,False,2171,Nebraska
14,School Totals,200,19,48,.396,14,27,.519,5,21,.238,34,48,.708,9,23,32,13,8,2,9,21,77,False,3495,Northwestern
11,School Totals,200,19,46,.413,12,23,.522,7,23,.304,9,12,.750,6,19,25,15,2,3,16,14,54,False,3496,Northwestern
11,School Totals,200,21,43,.488,9,15,.600,12,28,.429,15,22,.682,7,14,21,18,8,2,14,18,69,False,3497,Northwestern
13,School Totals,200,27,55,.491,17,28,.607,10,27,.370,5,10,.500,8,21,29,22,12,6,13,22,69,False,3498,Northwestern
9,School Totals,200,24,56,.429,14,31,.452,10,25,.400,14,16,.875,5,24,29,17,6,6,4,16,72,False,3499,Northwestern
9,School Totals,200,24,50,.480,14,22,.636,10,28,.357,9,11,.818,7,21,28,17,6,3,11,14,67,False,3500,Northwestern
10,School Totals,200,24,49,.490,18,35,.514,6,14,.429,11,16,.688,9,24,33,11,9,9,16,16,65,False,3501,Northwestern
12,School Totals,200,28,63,.444,8,16,.500,20,47,.426,14,19,.737,8,33,41,24,5,5,11,21,90,False,3502,Northwestern
12,School Totals,200,30,60,.500,16,32,.500,14,28,.500,10,13,.769,12,18,30,25,14,4,13,16,84,False,3503,Northwestern
11,School Totals,200,21,53,.396,15,28,.536,6,25,.240,22,33,.667,8,24,32,15,11,3,8,13,70,False,3504,Northwestern
12,School Totals,200,27,51,.529,22,29,.759,5,22,.227,15,21,.714,5,22,27,21,5,5,8,19,74,False,3505,Northwestern
9,School Totals,225,28,84,.333,12,37,.324,16,47,.340,11,15,.733,12,24,36,21,4,2,3,20,83,False,2500,Northwestern
13,School Totals,200,23,62,.371,14,36,.389,9,26,.346,15,23,.652,11,14,25,16,6,1,10,21,70,False,1185,Northwestern
10,School Totals,200,16,50,.320,11,28,.393,5,22,.227,16,25,.640,13,27,40,12,6,9,19,14,53,False,3506,Northwestern
11,School Totals,200,23,52,.442,12,28,.429,11,24,.458,11,17,.647,8,16,24,14,7,4,12,16,68,False,797,Northwestern
8,School Totals,200,18,45,.400,13,33,.394,5,12,.417,9,16,.563,7,19,26,13,1,3,6,17,50,False,3507,Northwestern
9,School Totals,200,21,45,.467,17,35,.486,4,10,.400,26,30,.867,6,25,31,13,3,2,15,17,72,False,3508,Northwestern
13,School Totals,200,18,47,.383,9,24,.375,9,23,.391,11,18,.611,7,18,25,13,7,1,14,21,56,False,1554,Northwestern
11,School Totals,200,21,52,.404,14,24,.583,7,28,.250,24,32,.750,10,18,28,15,5,1,7,17,73,False,2504,Northwestern
10,School Totals,200,22,56,.393,10,27,.370,12,29,.414,5,6,.833,7,19,26,18,7,2,10,16,61,False,3039,Northwestern
10,School Totals,200,23,54,.426,12,27,.444,11,27,.407,13,15,.867,6,18,24,14,3,2,12,27,70,False,1192,Northwestern
14,School Totals,200,25,46,.543,15,26,.577,10,20,.500,7,7,1.000,4,24,28,21,2,4,11,15,67,False,803,Northwestern
14,School Totals,200,25,48,.521,15,23,.652,10,25,.400,18,26,.692,7,21,28,21,4,9,9,21,78,False,21,Northwestern
11,School Totals,200,25,57,.439,17,31,.548,8,26,.308,7,13,.538,8,18,26,12,3,2,6,23,65,False,2783,Northwestern
10,School Totals,225,24,60,.400,11,24,.458,13,36,.361,16,19,.842,11,21,32,18,10,6,13,17,77,False,3040,Northwestern
9,School Totals,200,28,58,.483,18,29,.621,10,29,.345,4,11,.364,3,12,15,15,10,4,9,22,70,False,1896,Northwestern
9,School Totals,200,21,42,.500,17,29,.586,4,13,.308,17,22,.773,3,12,15,10,4,0,6,21,63,False,3509,Northwestern
14,School Totals,200,28,48,.583,22,30,.733,6,18,.333,12,15,.800,5,17,22,21,3,6,8,20,74,False,2785,Northwestern
12,School Totals,200,17,53,.321,5,25,.200,12,28,.429,14,22,.636,11,16,27,15,6,2,11,20,60,False,1897,Northwestern
13,School Totals,200,26,53,.491,13,22,.591,13,31,.419,7,14,.500,9,23,32,22,14,7,17,18,72,False,3510,Northwestern
10,School Totals,225,29,72,.403,16,30,.533,13,42,.310,9,15,.600,17,14,31,21,10,5,12,25,80,False,29,Northwestern
13,School Totals,200,24,58,.414,17,27,.630,7,31,.226,18,20,.900,13,14,27,17,10,5,6,20,73,False,30,Northwestern
11,School Totals,200,16,43,.372,8,20,.400,8,23,.348,21,27,.778,7,22,29,11,5,6,15,28,61,False,3511,Northwestern
9,School Totals,200,24,61,.393,15,32,.469,9,29,.310,7,10,.700,11,20,31,14,5,2,12,25,64,False,3512,Northwestern
13,School Totals,200,35,70,.500,20,37,.541,15,33,.455,12,14,.857,15,19,34,17,6,2,11,17,97,False,3513,Northwestern
10,School Totals,200,24,53,.453,18,37,.486,6,16,.375,23,29,.793,6,16,22,13,7,2,5,11,77,False,3514,Northwestern
14,School Totals,200,24,51,.471,14,22,.636,10,29,.345,13,17,.765,7,25,32,19,11,5,12,18,71,False,3515,Northwestern
11,School Totals,200,24,49,.490,17,29,.586,7,20,.350,10,17,.588,4,23,27,12,8,3,11,15,65,False,3516,Northwestern
14,School Totals,200,31,48,.646,19,29,.655,12,19,.632,17,30,.567,4,24,28,20,6,3,14,18,91,False,3517,Northwestern
12,School Totals,200,29,58,.500,19,32,.594,10,26,.385,13,25,.520,7,23,30,24,9,1,9,21,81,False,3518,Northwestern
14,School Totals,200,25,50,.500,18,34,.529,7,16,.438,21,25,.840,6,20,26,18,9,4,10,15,78,False,3519,Northwestern
13,School Totals,200,34,67,.507,24,45,.533,10,22,.455,14,18,.778,11,24,35,26,10,6,11,20,92,False,3520,Northwestern
12,School Totals,200,25,62,.403,15,35,.429,10,27,.370,9,14,.643,11,15,26,15,8,2,13,21,69,False,3521,Northwestern
12,School Totals,200,29,61,.475,23,37,.622,6,24,.250,6,10,.600,9,27,36,25,9,2,10,7,70,False,3522,Northwestern
9,School Totals,200,26,57,.456,18,40,.450,8,17,.471,9,16,.563,7,18,25,15,6,5,10,22,69,False,3523,Northwestern
9,School Totals,200,18,57,.316,8,34,.235,10,23,.435,16,24,.667,6,18,24,12,8,4,10,12,62,False,1218,Northwestern
13,School Totals,200,23,67,.343,14,29,.483,9,38,.237,8,10,.800,6,10,16,12,13,2,9,18,63,False,2528,Northwestern
9,School Totals,200,28,57,.491,18,37,.486,10,20,.500,27,38,.711,11,18,29,23,6,10,8,19,93,False,47,Northwestern
13,School Totals,200,33,62,.532,19,34,.559,14,28,.500,10,13,.769,10,20,30,23,9,2,14,16,90,False,2801,Northwestern
10,School Totals,225,24,53,.453,18,33,.545,6,20,.300,13,18,.722,2,23,25,13,5,1,14,21,67,False,1221,Northwestern
13,School Totals,200,27,56,.482,17,32,.531,10,24,.417,10,14,.714,7,25,32,18,2,2,4,17,74,False,831,Northwestern
12,School Totals,200,36,62,.581,25,39,.641,11,23,.478,15,18,.833,12,21,33,25,11,6,11,12,98,False,3524,Northwestern
12,School Totals,200,17,41,.415,15,31,.484,2,10,.200,10,13,.769,3,14,17,9,2,2,5,10,46,False,3525,Northwestern
10,School Totals,200,24,64,.375,12,25,.480,12,39,.308,10,11,.909,10,21,31,20,7,2,10,31,70,False,3059,Northwestern
8,School Totals,200,20,51,.392,11,21,.524,9,30,.300,8,11,.727,8,14,22,16,1,2,6,19,57,False,1588,Northwestern
10,School Totals,200,23,48,.479,14,27,.519,9,21,.429,16,22,.727,5,18,23,16,7,4,10,17,71,False,2530,Northwestern
9,School Totals,200,26,56,.464,15,31,.484,11,25,.440,3,7,.429,7,18,25,16,7,3,11,18,66,False,837,Northwestern
13,School Totals,200,18,52,.346,16,31,.516,2,21,.095,3,5,.600,4,16,20,9,5,2,9,17,41,False,1916,Northwestern
9,School Totals,200,27,60,.450,15,32,.469,12,28,.429,7,13,.538,9,18,27,17,10,2,7,11,73,False,2805,Northwestern
10,School Totals,200,19,43,.442,8,19,.421,11,24,.458,21,25,.840,4,15,19,13,4,2,11,20,70,False,57,Northwestern
9,School Totals,200,20,52,.385,14,28,.500,6,24,.250,6,9,.667,6,13,19,14,6,2,10,19,52,False,1919,Northwestern
9,School Totals,200,22,47,.468,11,26,.423,11,21,.524,8,11,.727,3,15,18,12,4,1,6,20,63,False,3526,Northwestern
12,School Totals,200,19,51,.373,9,21,.429,10,30,.333,20,23,.870,8,19,27,16,6,6,9,14,68,False,3061,Northwestern
11,School Totals,200,24,57,.421,15,26,.577,9,31,.290,18,23,.783,7,23,30,15,4,4,5,21,75,False,3062,Northwestern
8,School Totals,225,19,51,.373,12,30,.400,7,21,.333,16,18,.889,5,19,24,7,2,6,5,23,61,False,1595,Northwestern
12,School Totals,200,22,58,.379,10,24,.417,12,34,.353,14,16,.875,16,19,35,17,9,2,10,9,70,False,3527,Northwestern
13,School Totals,200,34,62,.548,19,26,.731,15,36,.417,2,3,.667,9,18,27,27,6,2,8,16,85,False,3528,Northwestern
9,School Totals,225,24,64,.375,14,26,.538,10,38,.263,8,10,.800,8,27,35,14,4,5,11,19,66,False,3529,Northwestern
11,School Totals,200,21,48,.438,16,26,.615,5,22,.227,13,20,.650,6,25,31,17,6,3,7,15,60,False,3530,Northwestern
10,School Totals,200,26,59,.441,14,28,.500,12,31,.387,24,28,.857,10,15,25,15,10,5,12,21,88,False,3531,Northwestern
10,School Totals,200,22,59,.373,13,36,.361,9,23,.391,16,22,.727,6,14,20,12,9,5,6,18,69,False,3532,Northwestern
9,School Totals,200,28,50,.560,21,29,.724,7,21,.333,17,19,.895,4,18,22,14,3,6,6,12,80,False,3533,Northwestern
9,School Totals,200,21,48,.438,12,19,.632,9,29,.310,12,18,.667,5,24,29,15,3,3,9,11,63,False,3534,Northwestern
12,School Totals,200,31,56,.554,26,42,.619,5,14,.357,9,14,.643,5,24,29,15,11,4,13,19,76,False,3535,Northwestern
12,School Totals,200,34,67,.507,14,28,.500,20,39,.513,4,7,.571,8,28,36,30,2,2,8,14,92,False,3536,Northwestern
10,School Totals,200,14,58,.241,10,32,.313,4,26,.154,9,14,.643,12,14,26,13,3,2,11,17,41,False,3537,Northwestern
11,School Totals,200,29,61,.475,16,32,.500,13,29,.448,10,17,.588,8,22,30,24,11,7,11,16,81,False,3538,Northwestern
10,School Totals,200,25,57,.439,16,28,.571,9,29,.310,11,14,.786,6,22,28,15,3,5,12,13,70,False,3539,Northwestern
11,School Totals,200,32,59,.542,20,36,.556,12,23,.522,11,18,.611,10,20,30,26,9,8,11,11,87,False,3540,Northwestern
9,School Totals,200,29,58,.500,20,36,.556,9,22,.409,12,12,1.000,5,18,23,22,7,1,10,22,79,False,3541,Northwestern
10,School Totals,200,17,53,.321,10,33,.303,7,20,.350,13,19,.684,5,23,28,10,3,1,11,22,54,False,1613,Northwestern
9,School Totals,200,22,40,.550,13,19,.684,9,21,.429,15,25,.600,3,22,25,13,6,5,12,16,68,False,1936,Northwestern
9,School Totals,200,20,55,.364,15,37,.405,5,18,.278,11,18,.611,9,20,29,10,11,6,8,19,56,False,2551,Northwestern
8,School Totals,225,24,48,.500,18,35,.514,6,13,.462,10,15,.667,3,27,30,10,3,3,15,14,64,False,862,Northwestern
9,School Totals,200,26,52,.500,18,35,.514,8,17,.471,21,29,.724,7,17,24,20,7,4,6,18,81,False,1252,Northwestern
10,School Totals,200,19,45,.422,14,31,.452,5,14,.357,14,19,.737,4,18,22,8,7,0,10,13,57,False,3542,Northwestern
11,School Totals,200,18,55,.327,10,29,.345,8,26,.308,8,20,.400,5,19,24,12,5,3,10,16,52,False,3077,Northwestern
8,School Totals,200,20,45,.444,12,24,.500,8,21,.381,8,14,.571,11,22,33,16,0,7,16,12,56,False,3543,Northwestern
7,School Totals,200,23,51,.451,9,20,.450,14,31,.452,24,29,.828,8,18,26,17,10,3,8,12,84,False,3342,Northwestern
7,School Totals,200,29,48,.604,21,28,.750,8,20,.400,8,15,.533,5,17,22,12,5,0,10,16,74,False,2555,Northwestern
10,School Totals,200,27,48,.563,14,23,.609,13,25,.520,16,23,.696,7,13,20,22,11,3,7,15,83,False,2826,Northwestern
9,School Totals,200,28,57,.491,18,34,.529,10,23,.435,11,17,.647,6,19,25,15,2,4,8,24,77,False,3544,Northwestern
9,School Totals,200,24,49,.490,18,29,.621,6,20,.300,12,17,.706,5,16,21,9,6,3,12,19,66,False,88,Northwestern
9,School Totals,200,21,48,.438,11,20,.550,10,28,.357,12,18,.667,5,15,20,14,9,5,8,15,64,False,3080,Northwestern
9,School Totals,225,21,51,.412,18,35,.514,3,16,.188,10,14,.714,11,22,33,11,3,4,14,20,55,False,872,Northwestern
8,School Totals,200,22,50,.440,7,21,.333,15,29,.517,8,12,.667,4,14,18,15,8,6,9,13,67,False,1946,Northwestern
9,School Totals,200,26,52,.500,13,25,.520,13,27,.481,8,13,.615,4,12,16,21,7,2,7,15,73,False,1624,Northwestern
9,School Totals,200,24,57,.421,19,40,.475,5,17,.294,17,23,.739,13,11,24,11,11,0,10,17,70,False,2829,Northwestern
8,School Totals,225,20,57,.351,9,31,.290,11,26,.423,17,21,.810,5,19,24,11,12,3,8,14,68,False,3083,Northwestern
9,School Totals,200,29,62,.468,19,35,.543,10,27,.370,8,11,.727,9,20,29,25,6,5,6,12,76,False,3545,Northwestern
11,School Totals,200,18,51,.353,9,27,.333,9,24,.375,10,17,.588,8,16,24,12,10,5,15,15,55,False,3546,Northwestern
13,School Totals,200,29,58,.500,18,33,.545,11,25,.440,10,14,.714,6,34,40,24,6,7,11,16,79,False,3547,Northwestern
10,School Totals,200,27,54,.500,15,31,.484,12,23,.522,15,26,.577,8,21,29,25,8,3,12,23,81,False,3548,Northwestern
14,School Totals,200,33,70,.471,28,48,.583,5,22,.227,9,13,.692,13,32,45,24,3,5,8,9,80,False,3549,Northwestern
10,School Totals,200,26,52,.500,14,30,.467,12,22,.545,5,9,.556,10,22,32,21,4,4,8,9,69,False,3550,Northwestern
14,School Totals,200,18,47,.383,12,28,.429,6,19,.316,13,14,.929,2,29,31,12,6,2,7,16,55,False,3551,Northwestern
10,School Totals,225,20,59,.339,11,35,.314,9,24,.375,23,27,.852,13,24,37,10,11,1,17,15,72,False,3552,Northwestern
13,School Totals,200,18,53,.340,12,28,.429,6,25,.240,15,22,.682,3,12,15,14,5,3,4,14,57,False,497,Northwestern
10,School Totals,200,15,43,.349,11,27,.407,4,16,.250,10,20,.500,7,21,28,11,2,5,16,16,44,False,3553,Northwestern
9,School Totals,200,25,49,.510,19,33,.576,6,16,.375,18,29,.621,10,26,36,18,2,1,15,22,74,False,3554,Northwestern
9,School Totals,200,18,55,.327,11,31,.355,7,24,.292,22,31,.710,14,16,30,10,3,3,13,23,65,False,3555,Northwestern
10,School Totals,200,24,55,.436,12,28,.429,12,27,.444,14,25,.560,5,21,26,19,11,4,11,16,74,False,3556,Northwestern
10,School Totals,200,24,56,.429,19,43,.442,5,13,.385,15,20,.750,8,18,26,14,7,3,7,14,68,False,3557,Northwestern
12,School Totals,200,23,47,.489,10,23,.435,13,24,.542,4,5,.800,2,23,25,21,5,7,11,11,63,False,3558,Northwestern
11,School Totals,200,24,59,.407,14,31,.452,10,28,.357,8,17,.471,8,13,21,19,7,4,12,12,66,False,892,Northwestern
13,School Totals,200,20,52,.385,13,29,.448,7,23,.304,4,6,.667,8,12,20,11,11,1,11,20,51,False,3102,Northwestern
11,School Totals,200,22,48,.458,13,26,.500,9,22,.409,17,26,.654,6,24,30,12,6,7,6,16,70,False,1961,Northwestern
12,School Totals,200,15,51,.294,10,25,.400,5,26,.192,15,25,.600,7,21,28,9,6,5,9,14,50,False,2845,Northwestern
10,School Totals,200,17,36,.472,9,21,.429,8,15,.533,26,31,.839,3,18,21,10,5,0,14,19,68,False,2578,Northwestern
10,School Totals,200,20,49,.408,14,30,.467,6,19,.316,13,18,.722,5,13,18,13,2,2,6,21,59,False,116,Northwestern
11,School Totals,200,17,40,.425,13,28,.464,4,12,.333,17,32,.531,5,18,23,11,9,3,11,16,55,False,3103,Northwestern
12,School Totals,200,18,56,.321,12,27,.444,6,29,.207,7,16,.438,9,22,31,9,8,1,11,18,49,False,3360,Northwestern
12,School Totals,200,19,51,.373,15,32,.469,4,19,.211,4,8,.500,10,18,28,10,1,2,6,14,46,False,899,Northwestern
10,School Totals,200,26,49,.531,15,23,.652,11,26,.423,12,18,.667,4,23,27,24,4,12,5,16,75,False,3559,Northwestern
12,School Totals,200,20,57,.351,14,32,.438,6,25,.240,11,13,.846,12,18,30,12,6,0,11,17,57,False,2850,Northwestern
10,School Totals,200,23,50,.460,12,24,.500,11,26,.423,2,3,.667,4,12,16,17,4,0,7,19,59,False,1650,Northwestern
11,School Totals,200,12,48,.250,7,21,.333,5,27,.185,12,15,.800,5,17,22,9,5,2,14,10,41,False,2583,Northwestern
11,School Totals,200,15,51,.294,7,27,.259,8,24,.333,3,5,.600,4,15,19,11,5,1,7,18,41,False,3560,Northwestern
11,School Totals,200,16,56,.286,12,38,.316,4,18,.222,7,12,.583,7,14,21,12,8,6,11,18,43,False,3561,Northwestern
9,School Totals,200,18,43,.419,10,24,.417,8,19,.421,9,9,1.000,4,22,26,12,2,0,15,19,53,False,1653,Northwestern
10,School Totals,200,17,49,.347,9,26,.346,8,23,.348,17,19,.895,4,15,19,15,8,1,15,19,59,False,1970,Northwestern
9,School Totals,200,24,56,.429,17,29,.586,7,27,.259,6,9,.667,11,10,21,14,6,0,7,19,61,False,1295,Northwestern
11,School Totals,200,18,49,.367,11,27,.407,7,22,.318,16,21,.762,3,24,27,14,4,7,9,23,59,False,2855,Northwestern
12,School Totals,200,20,43,.465,10,22,.455,10,21,.476,22,29,.759,5,31,36,16,1,4,12,26,72,False,3562,Northwestern
10,School Totals,200,21,54,.389,11,26,.423,10,28,.357,6,11,.545,9,21,30,12,4,3,16,20,58,False,3563,Northwestern
11,School Totals,200,21,58,.362,16,39,.410,5,19,.263,17,27,.630,8,28,36,14,2,3,7,18,64,False,3564,Northwestern
11,School Totals,200,31,51,.608,20,31,.645,11,20,.550,20,32,.625,7,35,42,17,5,2,12,23,93,False,3565,Northwestern
10,School Totals,200,24,58,.414,19,42,.452,5,16,.313,10,12,.833,10,17,27,14,5,2,8,19,63,False,3566,Northwestern
10,School Totals,200,27,54,.500,24,38,.632,3,16,.188,15,21,.714,7,23,30,17,5,8,11,19,72,False,3567,Northwestern
11,School Totals,200,19,44,.432,10,20,.500,9,24,.375,20,25,.800,4,13,17,11,4,1,14,22,67,False,3568,Northwestern
12,School Totals,200,23,50,.460,11,18,.611,12,32,.375,21,27,.778,5,19,24,14,1,0,14,16,79,False,3569,Northwestern
12,School Totals,200,13,52,.250,7,30,.233,6,22,.273,16,18,.889,9,22,31,6,3,0,11,14,48,False,3570,Northwestern
12,School Totals,200,18,55,.327,15,36,.417,3,19,.158,12,18,.667,8,29,37,13,9,1,8,22,51,False,3571,Northwestern
10,School Totals,200,29,54,.537,24,38,.632,5,16,.313,23,31,.742,8,29,37,14,4,7,7,18,86,False,3572,Northwestern
10,School Totals,200,21,59,.356,15,33,.455,6,26,.231,10,15,.667,8,28,36,11,6,7,13,17,58,False,3573,Northwestern
11,School Totals,200,17,53,.321,9,29,.310,8,24,.333,14,23,.609,2,29,31,13,7,6,15,21,56,False,3574,Northwestern
11,School Totals,200,19,55,.345,16,39,.410,3,16,.188,8,11,.727,8,15,23,8,2,5,7,12,49,False,3575,Northwestern
12,School Totals,200,19,49,.388,13,26,.500,6,23,.261,7,8,.875,4,16,20,12,3,3,11,16,51,False,929,Northwestern
12,School Totals,200,23,59,.390,18,35,.514,5,24,.208,16,25,.640,9,16,25,4,6,2,13,28,67,False,2875,Northwestern
10,School Totals,200,16,43,.372,9,22,.409,7,21,.333,10,17,.588,3,30,33,13,1,2,11,13,49,False,2603,Northwestern
9,School Totals,200,13,46,.283,8,23,.348,5,23,.217,9,12,.750,7,18,25,7,2,7,12,15,40,False,1316,Northwestern
9,School Totals,200,19,51,.373,14,35,.400,5,16,.313,11,17,.647,5,31,36,5,4,8,9,19,54,False,152,Northwestern
11,School Totals,250,22,62,.355,18,38,.474,4,24,.167,15,22,.682,7,31,38,9,5,10,9,20,63,False,3576,Northwestern
12,School Totals,200,20,55,.364,16,35,.457,4,20,.200,6,9,.667,3,14,17,12,8,7,10,18,50,False,2877,Northwestern
9,School Totals,200,23,48,.479,16,32,.500,7,16,.438,12,16,.750,2,34,36,14,6,3,14,24,65,False,3577,Northwestern
10,School Totals,200,20,46,.435,12,25,.480,8,21,.381,7,7,1.000,3,21,24,10,5,2,9,14,55,False,3127,Northwestern
9,School Totals,200,17,46,.370,9,24,.375,8,22,.364,7,10,.700,2,24,26,13,6,2,12,13,49,False,3376,Northwestern
12,School Totals,200,24,52,.462,15,28,.536,9,24,.375,13,16,.813,5,18,23,13,2,2,9,15,70,False,1322,Northwestern
10,School Totals,200,16,53,.302,10,34,.294,6,19,.316,10,14,.714,8,17,25,9,9,4,8,17,48,False,3130,Northwestern
11,School Totals,200,23,50,.460,18,29,.621,5,21,.238,9,14,.643,3,17,20,4,2,1,12,23,60,False,1684,Northwestern
9,School Totals,200,19,49,.388,12,23,.522,7,26,.269,11,17,.647,12,15,27,9,3,5,9,17,56,False,160,Northwestern
10,School Totals,200,15,45,.333,8,18,.444,7,27,.259,10,16,.625,3,22,25,7,5,4,9,20,47,False,3378,Northwestern
11,School Totals,200,10,43,.233,7,21,.333,3,22,.136,9,21,.429,7,17,24,6,3,1,12,14,32,False,1994,Northwestern
9,School Totals,200,21,51,.412,14,33,.424,7,18,.389,25,34,.735,5,25,30,12,7,4,6,21,74,False,3578,Northwestern
8,School Totals,200,23,44,.523,12,21,.571,11,23,.478,10,13,.769,4,23,27,14,4,4,13,20,67,False,2881,Northwestern
10,School Totals,200,19,47,.404,12,28,.429,7,19,.368,6,8,.750,4,17,21,11,3,1,11,14,51,False,1328,Northwestern
11,School Totals,200,23,60,.383,17,38,.447,6,22,.273,13,19,.684,13,20,33,13,1,3,5,17,65,False,3579,Northwestern
12,School Totals,200,22,50,.440,14,36,.389,8,14,.571,17,21,.810,10,28,38,11,5,1,15,26,69,False,3580,Northwestern
11,School Totals,200,25,56,.446,15,33,.455,10,23,.435,9,12,.750,8,22,30,18,6,3,14,18,69,False,3581,Northwestern
12,School Totals,225,19,47,.404,16,33,.485,3,14,.214,27,37,.730,3,31,34,17,4,8,16,14,68,False,3582,Northwestern
13,School Totals,200,19,48,.396,10,26,.385,9,22,.409,8,13,.615,8,27,35,11,2,10,15,19,55,False,3583,Northwestern
13,School Totals,200,16,53,.302,11,32,.344,5,21,.238,5,8,.625,10,15,25,6,0,5,10,18,42,False,3584,Northwestern
13,School Totals,200,23,55,.418,19,32,.594,4,23,.174,8,14,.571,8,22,30,14,3,6,12,22,58,False,3585,Northwestern
12,School Totals,200,22,54,.407,16,36,.444,6,18,.333,6,7,.857,5,22,27,14,2,0,12,26,56,False,3586,Northwestern
13,School Totals,200,39,68,.574,28,44,.636,11,24,.458,12,22,.545,12,36,48,25,10,4,11,21,101,False,3587,Northwestern
11,School Totals,200,26,62,.419,20,43,.465,6,19,.316,9,11,.818,12,12,24,17,2,3,8,19,67,False,3588,Northwestern
10,School Totals,200,23,54,.426,17,34,.500,6,20,.300,15,23,.652,13,22,35,16,4,3,7,24,67,False,3589,Northwestern
10,School Totals,200,22,41,.537,17,28,.607,5,13,.385,14,20,.700,2,28,30,15,5,9,11,15,63,False,3590,Northwestern
13,School Totals,200,26,59,.441,20,38,.526,6,21,.286,18,18,1.000,11,29,40,17,5,6,8,16,76,False,3591,Northwestern
12,School Totals,200,16,41,.390,9,21,.429,7,20,.350,12,18,.667,2,29,31,8,4,2,15,14,51,False,2346,Northwestern
12,School Totals,200,24,61,.393,20,47,.426,4,14,.286,6,8,.750,7,21,28,16,1,0,9,16,58,False,3592,Northwestern
12,School Totals,225,26,55,.473,14,30,.467,12,25,.480,13,16,.813,7,23,30,17,1,1,13,19,77,False,1348,Northwestern
13,School Totals,200,24,52,.462,17,31,.548,7,21,.333,12,13,.923,7,27,34,14,0,4,11,16,67,False,2627,Northwestern
12,School Totals,200,22,52,.423,17,32,.531,5,20,.250,5,6,.833,8,30,38,12,1,2,11,16,54,False,968,Northwestern
10,School Totals,200,24,54,.444,17,33,.515,7,21,.333,12,14,.857,8,19,27,14,6,4,10,16,67,False,1707,Northwestern
10,School Totals,200,26,48,.542,18,28,.643,8,20,.400,7,9,.778,5,25,30,15,4,4,15,22,67,False,581,Northwestern
11,School Totals,200,23,55,.418,17,40,.425,6,15,.400,8,11,.727,5,16,21,9,5,4,8,23,60,False,3593,Northwestern
12,School Totals,200,21,46,.457,10,19,.526,11,27,.407,7,10,.700,6,11,17,15,3,1,13,19,60,False,3394,Northwestern
12,School Totals,200,19,48,.396,15,34,.441,4,14,.286,8,12,.667,3,19,22,8,2,4,5,20,50,False,3594,Northwestern
11,School Totals,200,15,42,.357,12,27,.444,3,15,.200,11,17,.647,7,13,20,9,6,2,14,18,44,False,1353,Northwestern
11,School Totals,225,21,50,.420,12,30,.400,9,20,.450,15,20,.750,7,28,35,13,3,12,7,15,66,False,2902,Northwestern
10,School Totals,200,24,55,.436,9,23,.391,15,32,.469,9,13,.692,7,20,27,18,6,5,10,16,72,False,3154,Northwestern
12,School Totals,200,23,50,.460,16,32,.500,7,18,.389,7,10,.700,4,27,31,19,9,3,9,8,60,False,2020,Northwestern
10,School Totals,200,25,49,.510,17,29,.586,8,20,.400,14,17,.824,5,27,32,20,0,5,9,14,72,False,195,Northwestern
11,School Totals,200,21,49,.429,16,29,.552,5,20,.250,13,18,.722,3,17,20,11,4,1,10,16,60,False,2632,Northwestern
12,School Totals,250,32,67,.478,20,40,.500,12,27,.444,6,10,.600,11,22,33,22,3,3,8,17,82,False,977,Northwestern
13,School Totals,200,16,42,.381,8,22,.364,8,20,.400,12,14,.857,1,21,22,14,6,3,15,16,52,False,2904,Northwestern
12,School Totals,200,20,46,.435,15,34,.441,5,12,.417,11,16,.688,4,17,21,12,5,5,9,16,56,False,198,Northwestern
12,School Totals,200,29,64,.453,20,35,.571,9,29,.310,12,22,.545,13,31,44,18,3,5,6,19,79,False,3595,Northwestern
10,School Totals,200,27,61,.443,20,35,.571,7,26,.269,18,23,.783,8,20,28,17,5,2,7,22,79,False,3596,Northwestern
11,School Totals,225,31,59,.525,18,33,.545,13,26,.500,8,14,.571,11,22,33,19,3,5,14,22,83,False,3597,Northwestern
10,School Totals,200,22,52,.423,13,32,.406,9,20,.450,16,19,.842,4,16,20,14,7,3,12,13,69,False,3598,Northwestern
10,School Totals,200,21,45,.467,11,22,.500,10,23,.435,15,23,.652,4,27,31,15,6,1,14,20,67,False,3599,Northwestern
12,School Totals,200,32,58,.552,20,32,.625,12,26,.462,14,15,.933,9,27,36,22,6,10,15,24,90,False,3600,Northwestern
11,School Totals,225,32,67,.478,22,41,.537,10,26,.385,7,11,.636,8,24,32,15,5,5,12,21,81,False,3601,Northwestern
11,School Totals,200,30,58,.517,21,36,.583,9,22,.409,12,23,.522,10,28,38,24,2,11,9,20,81,False,3602,Northwestern
11,School Totals,200,29,56,.518,14,20,.700,15,36,.417,4,9,.444,7,28,35,24,3,8,7,11,77,False,3603,Northwestern
10,School Totals,200,26,60,.433,19,32,.594,7,28,.250,19,27,.704,11,37,48,21,4,10,11,19,78,False,3604,Northwestern
11,School Totals,225,27,69,.391,21,42,.500,6,27,.222,18,21,.857,11,30,41,16,1,2,5,24,78,False,3605,Northwestern
11,School Totals,200,36,59,.610,21,30,.700,15,29,.517,16,19,.842,8,24,32,30,3,1,10,23,103,False,3606,Northwestern
10,School Totals,200,28,52,.538,20,35,.571,8,17,.471,10,17,.588,7,22,29,17,2,6,10,9,74,False,3607,Northwestern
10,School Totals,201,29,58,.500,19,35,.543,10,23,.435,13,17,.765,13,23,36,14,3,1,6,11,81,False,3410,Northwestern
11,School Totals,200,22,59,.373,20,39,.513,2,20,.100,13,22,.591,8,24,32,11,7,2,11,16,59,False,607,Northwestern
11,School Totals,200,21,67,.313,15,42,.357,6,25,.240,8,15,.533,15,27,42,11,2,7,9,20,56,False,1733,Northwestern
12,School Totals,200,28,50,.560,17,25,.680,11,25,.440,10,11,.909,6,23,29,18,6,3,12,13,77,False,3169,Northwestern
11,School Totals,200,22,46,.478,18,34,.529,4,12,.333,22,34,.647,10,20,30,10,5,2,11,17,70,False,3608,Northwestern
12,School Totals,200,26,67,.388,23,41,.561,3,26,.115,7,15,.467,8,20,28,14,5,1,3,27,62,False,2041,Northwestern
10,School Totals,225,23,65,.354,18,44,.409,5,21,.238,5,12,.417,16,22,38,10,4,2,12,19,56,False,612,Northwestern
12,School Totals,200,25,55,.455,20,40,.500,5,15,.333,2,8,.250,3,16,19,12,3,2,12,18,57,False,220,Northwestern
11,School Totals,200,12,58,.207,8,35,.229,4,23,.174,17,19,.895,8,18,26,7,6,3,10,9,45,False,1386,Northwestern
12,School Totals,200,26,62,.419,15,32,.469,11,30,.367,8,14,.571,11,25,36,13,5,3,15,27,71,False,2922,Northwestern
13,School Totals,200,29,54,.537,17,27,.630,12,27,.444,12,19,.632,5,21,26,16,6,6,8,24,82,False,3172,Northwestern
11,School Totals,200,21,54,.389,9,27,.333,12,27,.444,9,12,.750,9,24,33,15,2,1,13,23,63,False,1739,Northwestern
11,School Totals,200,22,52,.423,13,26,.500,9,26,.346,5,10,.500,6,24,30,18,2,3,11,14,58,False,2654,Northwestern
11,School Totals,200,25,56,.446,19,29,.655,6,27,.222,5,8,.625,7,14,21,13,2,4,5,26,61,False,3609,Northwestern
11,School Totals,200,25,54,.463,17,28,.607,8,26,.308,5,9,.556,4,17,21,17,2,0,9,20,63,False,1006,Northwestern
13,School Totals,200,37,69,.536,20,41,.488,17,28,.607,7,14,.500,18,25,43,33,3,6,7,22,98,False,2376,Northwestern
9,School Totals,200,25,52,.481,16,33,.485,9,19,.474,12,16,.750,4,19,23,12,5,1,9,16,71,False,2048,Northwestern
9,School Totals,200,24,53,.453,21,39,.538,3,14,.214,14,18,.778,8,27,35,15,4,3,13,18,65,False,3414,Northwestern
11,School Totals,225,25,68,.368,14,41,.341,11,27,.407,9,12,.750,12,28,40,16,2,2,7,18,70,False,1009,Northwestern
12,School Totals,200,32,64,.500,21,38,.553,11,26,.423,19,29,.655,12,31,43,21,5,7,13,25,94,False,3610,Northwestern
10,School Totals,200,29,60,.483,24,47,.511,5,13,.385,23,26,.885,6,17,23,17,6,6,5,16,86,False,3611,Northwestern
11,School Totals,200,24,50,.480,15,30,.500,9,20,.450,11,14,.786,5,24,29,14,3,4,16,22,68,False,3612,Northwestern
10,School Totals,200,27,56,.482,17,33,.515,10,23,.435,13,16,.813,9,27,36,13,5,3,11,24,77,False,3613,Northwestern
10,School Totals,200,24,56,.429,12,34,.353,12,22,.545,6,7,.857,10,23,33,15,3,7,15,17,66,False,3614,Northwestern
12,School Totals,200,31,65,.477,23,43,.535,8,22,.364,16,20,.800,9,26,35,25,7,12,7,11,86,False,3615,Northwestern
11,School Totals,200,27,66,.409,21,40,.525,6,26,.231,5,9,.556,11,21,32,18,9,6,10,17,65,False,3616,Northwestern
10,School Totals,200,26,60,.433,16,38,.421,10,22,.455,18,24,.750,9,26,35,23,5,7,12,28,80,False,3617,Northwestern
11,School Totals,200,27,61,.443,18,36,.500,9,25,.360,20,24,.833,8,18,26,19,7,7,8,21,83,False,3618,Northwestern
10,School Totals,200,26,61,.426,18,34,.529,8,27,.296,8,11,.727,8,22,30,20,4,7,8,14,68,False,3619,Northwestern
10,School Totals,200,21,51,.412,13,27,.481,8,24,.333,17,26,.654,5,35,40,14,4,6,14,21,67,False,3620,Northwestern
11,School Totals,200,31,64,.484,22,38,.579,9,26,.346,16,18,.889,11,31,42,23,3,12,9,20,87,False,3621,Northwestern
9,School Totals,200,24,67,.358,17,42,.405,7,25,.280,17,27,.630,14,22,36,14,5,6,10,17,72,False,3622,Northwestern
10,School Totals,200,28,63,.444,17,37,.459,11,26,.423,20,26,.769,13,27,40,19,5,5,11,27,87,False,2063,Northwestern
10,School Totals,200,19,53,.358,12,34,.353,7,19,.368,7,12,.583,6,19,25,13,5,1,11,23,52,False,1411,Northwestern
11,School Totals,200,24,63,.381,18,37,.486,6,26,.231,12,13,.923,7,23,30,13,5,5,8,16,66,False,3188,Northwestern
10,School Totals,200,25,49,.510,14,25,.560,11,24,.458,13,14,.929,6,21,27,15,6,1,11,16,74,False,3428,Northwestern
11,School Totals,200,24,63,.381,21,43,.488,3,20,.150,18,20,.900,18,27,45,11,4,15,13,23,69,False,2394,Northwestern
12,School Totals,200,37,62,.597,26,38,.684,11,24,.458,4,9,.444,10,24,34,29,10,4,10,18,89,False,2943,Northwestern
10,School Totals,200,24,64,.375,17,40,.425,7,24,.292,19,24,.792,13,23,36,13,5,4,8,23,74,False,1764,Northwestern
11,School Totals,200,26,63,.413,20,48,.417,6,15,.400,15,19,.789,11,28,39,15,3,6,12,19,73,False,3429,Northwestern
10,School Totals,200,23,56,.411,18,38,.474,5,18,.278,17,21,.810,5,28,33,12,5,5,7,21,68,False,257,Northwestern
10,School Totals,200,21,60,.350,19,46,.413,2,14,.143,15,22,.682,7,19,26,8,9,3,6,22,59,False,3623,Northwestern
9,School Totals,200,19,56,.339,13,36,.361,6,20,.300,17,20,.850,8,25,33,10,5,2,14,19,61,False,2677,Northwestern
9,School Totals,200,26,58,.448,19,41,.463,7,17,.412,7,9,.778,6,23,29,11,7,3,6,16,66,False,3624,Northwestern
10,School Totals,200,23,59,.390,18,37,.486,5,22,.227,13,23,.565,7,21,28,12,6,8,8,17,64,False,653,Northwestern
11,School Totals,200,23,50,.460,16,28,.571,7,22,.318,16,21,.762,9,19,28,15,5,4,9,15,69,False,2400,Northwestern
10,School Totals,200,18,56,.321,14,38,.368,4,18,.222,10,14,.714,5,22,27,5,2,0,10,20,50,False,2679,Northwestern
10,School Totals,200,23,59,.390,19,41,.463,4,18,.222,12,18,.667,8,21,29,6,6,3,6,18,62,False,264,Northwestern
10,School Totals,200,27,51,.529,22,38,.579,5,13,.385,8,13,.615,7,20,27,20,2,3,12,18,67,False,1039,Northwestern
11,School Totals,200,27,60,.450,23,41,.561,4,19,.211,7,10,.700,8,22,30,16,2,1,7,19,65,False,3625,Northwestern
12,School Totals,200,30,50,.600,21,30,.700,9,20,.450,14,16,.875,9,20,29,19,3,4,11,13,83,False,2402,Northwestern
11,School Totals,200,26,47,.553,19,32,.594,7,15,.467,13,20,.650,7,20,27,15,7,3,15,17,72,False,659,Northwestern
11,School Totals,200,18,52,.346,15,38,.395,3,14,.214,9,11,.818,7,15,22,5,4,0,12,14,48,False,3626,Northwestern
10,School Totals,200,26,53,.491,20,39,.513,6,14,.429,10,18,.556,6,25,31,10,7,0,12,18,68,False,3627,Northwestern
12,School Totals,200,27,66,.409,19,42,.452,8,24,.333,11,13,.846,11,21,32,12,11,5,13,26,73,False,3628,Northwestern
10,School Totals,200,25,61,.410,20,40,.500,5,21,.238,24,37,.649,9,27,36,13,5,12,14,25,79,False,3629,Northwestern
10,School Totals,200,23,47,.489,17,31,.548,6,16,.375,23,24,.958,6,24,30,15,2,4,17,17,75,False,3630,Northwestern
10,School Totals,200,32,67,.478,20,39,.513,12,28,.429,12,19,.632,7,24,31,16,3,7,6,19,88,False,3631,Northwestern
12,School Totals,200,32,57,.561,20,36,.556,12,21,.571,6,6,1.000,8,21,29,15,1,7,14,18,82,False,3632,Northwestern
12,School Totals,200,12,45,.267,6,22,.273,6,23,.261,19,27,.704,6,13,19,6,5,0,17,18,49,False,3633,Northwestern
14,School Totals,200,27,57,.474,18,30,.600,9,27,.333,18,21,.857,7,21,28,19,9,2,10,15,81,False,3634,Northwestern
11,School Totals,200,21,58,.362,16,35,.457,5,23,.217,4,5,.800,7,20,27,10,6,1,6,17,51,False,3635,Northwestern
11,School Totals,225,23,59,.390,15,36,.417,8,23,.348,18,21,.857,6,22,28,13,8,4,17,28,72,False,2691,Northwestern
11,School Totals,200,30,63,.476,24,43,.558,6,20,.300,3,5,.600,8,22,30,17,5,4,7,18,69,False,3636,Northwestern
13,School Totals,200,27,55,.491,15,25,.600,12,30,.400,30,37,.811,7,24,31,20,10,5,9,20,96,False,3637,Northwestern
13,School Totals,200,28,61,.459,16,39,.410,12,22,.545,16,21,.762,9,22,31,19,9,5,7,17,84,False,3638,Northwestern
11,School Totals,200,24,60,.400,13,32,.406,11,28,.393,3,5,.600,10,24,34,13,5,4,16,25,62,False,3639,Northwestern
12,School Totals,200,27,59,.458,16,28,.571,11,31,.355,20,27,.741,9,25,34,21,7,5,11,22,85,False,3640,Northwestern
10,School Totals,200,29,65,.446,21,37,.568,8,28,.286,12,19,.632,12,18,30,13,3,1,13,23,78,False,3641,Northwestern
11,School Totals,200,33,61,.541,27,45,.600,6,16,.375,23,28,.821,8,25,33,19,7,9,9,18,95,False,3642,Northwestern
10,School Totals,200,19,65,.292,13,44,.295,6,21,.286,11,16,.688,18,17,35,14,3,6,11,17,55,False,3445,Northwestern
11,School Totals,200,23,62,.371,12,34,.353,11,28,.393,6,6,1.000,10,17,27,11,8,2,15,21,63,False,2091,Northwestern
10,School Totals,200,28,56,.500,17,32,.531,11,24,.458,16,25,.640,9,33,42,21,4,9,11,20,83,False,3207,Northwestern
12,School Totals,200,15,56,.268,8,31,.258,7,25,.280,9,9,1.000,10,25,35,8,6,5,17,20,46,False,287,Northwestern
9,School Totals,200,26,58,.448,18,31,.581,8,27,.296,5,10,.500,4,20,24,19,5,6,10,14,65,False,1788,Northwestern
10,School Totals,200,28,65,.431,23,46,.500,5,19,.263,9,14,.643,13,14,27,16,5,2,6,17,70,False,2094,Northwestern
10,School Totals,200,27,56,.482,22,39,.564,5,17,.294,18,23,.783,10,25,35,15,6,7,10,17,77,False,3209,Northwestern
10,School Totals,200,18,47,.383,14,31,.452,4,16,.250,7,10,.700,5,26,31,7,2,1,16,20,47,False,1069,Northwestern
10,School Totals,200,21,42,.500,17,31,.548,4,11,.364,14,17,.824,5,23,28,9,5,4,13,14,60,False,3643,Northwestern
10,School Totals,200,20,50,.400,12,27,.444,8,23,.348,13,17,.765,6,25,31,12,4,2,6,16,61,False,1071,Northwestern
11,School Totals,200,19,57,.333,10,33,.303,9,24,.375,10,13,.769,10,16,26,7,5,1,13,16,57,False,686,Northwestern
10,School Totals,225,23,61,.377,16,38,.421,7,23,.304,5,9,.556,11,21,32,13,2,6,12,18,58,False,2424,Northwestern
9,School Totals,200,21,56,.375,12,33,.364,9,23,.391,9,10,.900,8,18,26,14,4,2,6,22,60,False,1451,Northwestern
9,School Totals,200,21,50,.420,11,25,.440,10,25,.400,12,18,.667,7,17,24,14,5,4,13,20,64,False,689,Northwestern
10,School Totals,200,23,47,.489,19,34,.559,4,13,.308,14,17,.824,8,17,25,10,3,0,12,20,64,False,3644,Northwestern
10,School Totals,200,27,58,.466,14,33,.424,13,25,.520,3,7,.429,8,18,26,17,2,4,10,18,70,False,2967,Northwestern
10,School Totals,200,21,52,.404,16,33,.485,5,19,.263,10,15,.667,9,25,34,12,2,5,8,15,57,False,2100,Northwestern
11,School Totals,200,25,60,.417,14,30,.467,11,30,.367,21,26,.808,14,22,36,16,7,6,8,18,82,False,3645,Northwestern
11,School Totals,200,21,58,.362,17,36,.472,4,22,.182,17,24,.708,11,29,40,12,6,4,9,17,63,False,3646,Northwestern
11,School Totals,200,32,62,.516,27,45,.600,5,17,.294,13,21,.619,13,29,42,23,10,6,15,15,82,False,3647,Northwestern
11,School Totals,200,18,51,.353,12,29,.414,6,22,.273,17,23,.739,6,19,25,11,3,2,15,23,59,False,3648,Northwestern
11,School Totals,200,24,50,.480,16,27,.593,8,23,.348,35,43,.814,10,24,34,18,7,1,17,25,91,False,3649,Northwestern
11,School Totals,200,27,53,.509,17,32,.531,10,21,.476,15,22,.682,12,14,26,12,4,4,15,20,79,False,3650,Northwestern
10,School Totals,200,23,54,.426,16,34,.471,7,20,.350,14,21,.667,10,21,31,16,9,4,15,21,67,False,3651,Northwestern
10,School Totals,200,27,61,.443,22,44,.500,5,17,.294,7,10,.700,7,22,29,9,4,2,10,20,66,False,308,Northwestern
11,School Totals,200,23,51,.451,17,34,.500,6,17,.353,8,13,.615,5,20,25,12,3,6,9,12,60,False,1094,Northwestern
10,School Totals,200,23,55,.418,12,24,.500,11,31,.355,18,23,.783,7,27,34,21,3,8,10,14,75,False,3652,Northwestern
12,School Totals,200,33,65,.508,20,31,.645,13,34,.382,9,14,.643,10,23,33,23,8,6,7,17,88,False,3653,Northwestern
10,School Totals,225,28,66,.424,20,43,.465,8,23,.348,5,9,.556,7,25,32,20,7,10,10,13,69,False,3654,Northwestern
10,School Totals,200,23,55,.418,13,31,.419,10,24,.417,19,24,.792,5,30,35,16,3,2,10,16,75,False,3655,Northwestern
11,School Totals,200,22,64,.344,19,46,.413,3,18,.167,8,12,.667,5,16,21,16,4,2,8,20,55,False,1470,Northwestern
10,School Totals,200,20,49,.408,12,30,.400,8,19,.421,20,26,.769,4,25,29,14,5,5,15,22,68,False,2718,Northwestern
10,School Totals,200,22,57,.386,15,30,.500,7,27,.259,12,16,.750,7,23,30,13,4,4,8,21,63,False,2982,Northwestern
11,School Totals,200,23,54,.426,19,37,.514,4,17,.235,10,13,.769,6,20,26,11,4,5,13,13,60,False,1101,Northwestern
9,School Totals,200,21,53,.396,12,31,.387,9,22,.409,14,17,.824,6,23,29,12,6,4,14,21,65,False,2441,Northwestern
10,School Totals,200,21,53,.396,11,29,.379,10,24,.417,21,29,.724,4,23,27,17,4,8,5,18,73,False,319,Northwestern
10,School Totals,200,16,54,.296,9,35,.257,7,19,.368,7,8,.875,6,28,34,7,5,3,13,14,46,False,3656,Northwestern
12,School Totals,200,18,58,.310,13,35,.371,5,23,.217,11,15,.733,5,22,27,8,7,2,7,19,52,False,712,Northwestern
10,School Totals,200,20,63,.317,13,41,.317,7,22,.318,5,7,.714,11,22,33,13,7,4,13,21,52,False,2124,Northwestern
10,School Totals,200,29,56,.518,21,33,.636,8,23,.348,13,18,.722,10,24,34,13,5,0,14,23,79,False,2984,Northwestern
10,School Totals,200,20,55,.364,13,32,.406,7,23,.304,9,15,.600,4,21,25,16,6,3,8,17,56,False,2444,Northwestern
10,School Totals,200,20,58,.345,15,33,.455,5,25,.200,5,8,.625,10,29,39,8,4,5,15,14,50,False,3463,Northwestern
10,School Totals,200,18,57,.316,13,28,.464,5,29,.172,8,12,.667,8,25,33,8,4,0,7,15,49,False,1820,Northwestern
9,School Totals,200,24,59,.407,18,38,.474,6,21,.286,10,14,.714,3,21,24,17,6,7,3,15,64,False,3657,Northwestern
11,School Totals,200,18,53,.340,11,29,.379,7,24,.292,7,10,.700,3,26,29,13,9,4,14,18,50,False,3229,Northwestern
11,School Totals,200,26,66,.394,19,38,.500,7,28,.250,17,22,.773,8,21,29,14,6,3,8,27,76,False,2726,Northwestern
11,School Totals,200,26,58,.448,21,38,.553,5,20,.250,11,13,.846,7,28,35,15,6,7,5,17,68,False,1823,Northwestern
11,School Totals,200,19,48,.396,8,24,.333,11,24,.458,8,8,1.000,1,21,22,13,3,4,11,18,57,False,3658,Northwestern
10,School Totals,225,25,72,.347,17,36,.472,8,36,.222,11,15,.733,12,29,41,14,7,3,9,19,69,False,2727,Northwestern
11,School Totals,200,20,53,.377,18,37,.486,2,16,.125,19,24,.792,8,24,32,14,1,2,13,19,61,False,3659,Northwestern
10,School Totals,200,23,47,.489,16,31,.516,7,16,.438,19,25,.760,6,32,38,17,7,4,19,19,72,False,3660,Northwestern
11,School Totals,200,20,60,.333,17,39,.436,3,21,.143,13,19,.684,8,19,27,10,5,4,10,19,56,False,3661,Northwestern
11,School Totals,200,19,56,.339,14,34,.412,5,22,.227,27,30,.900,13,28,41,15,5,1,10,16,70,False,3662,Northwestern
12,School Totals,200,30,57,.526,20,37,.541,10,20,.500,8,13,.615,10,26,36,12,6,3,10,18,78,False,3663,Northwestern
10,School Totals,200,19,52,.365,12,30,.400,7,22,.318,14,16,.875,2,26,28,6,2,3,12,16,59,False,3664,Northwestern
10,School Totals,200,32,55,.582,23,35,.657,9,20,.450,9,10,.900,6,26,32,18,5,0,13,15,82,False,3665,Northwestern
10,School Totals,200,18,53,.340,13,36,.361,5,17,.294,3,4,.750,3,25,28,10,3,3,12,15,44,False,3666,Northwestern
13,School Totals,200,26,64,.406,23,45,.511,3,19,.158,17,28,.607,13,20,33,20,10,2,6,10,72,False,3667,Northwestern
11,School Totals,200,26,61,.426,17,40,.425,9,21,.429,11,15,.733,2,20,22,15,8,4,8,15,72,False,1500,Northwestern
9,School Totals,200,31,59,.525,22,33,.667,9,26,.346,7,10,.700,5,27,32,18,4,2,15,21,78,False,3668,Northwestern
10,School Totals,200,23,62,.371,17,40,.425,6,22,.273,14,18,.778,7,23,30,17,7,1,5,15,66,False,3669,Northwestern
8,School Totals,200,26,59,.441,21,46,.457,5,13,.385,11,14,.786,4,21,25,17,5,1,8,15,68,False,3244,Northwestern
9,School Totals,200,25,56,.446,21,40,.525,4,16,.250,8,10,.800,5,21,26,13,4,4,12,23,62,False,350,Northwestern
9,School Totals,200,25,63,.397,15,34,.441,10,29,.345,2,5,.400,8,36,44,11,2,6,11,11,62,False,3480,Northwestern
10,School Totals,200,21,58,.362,16,41,.390,5,17,.294,15,21,.714,11,22,33,13,4,2,8,18,62,False,3002,Northwestern
9,School Totals,200,27,60,.450,19,41,.463,8,19,.421,9,12,.750,8,17,25,11,3,1,5,17,71,False,2742,Northwestern
9,School Totals,200,24,48,.500,17,32,.531,7,16,.438,11,13,.846,2,25,27,15,3,5,13,22,66,False,742,Northwestern
10,School Totals,200,22,58,.379,15,35,.429,7,23,.304,8,13,.615,9,20,29,12,2,2,12,12,59,False,1844,Northwestern
11,School Totals,200,19,54,.352,16,35,.457,3,19,.158,9,10,.900,5,20,25,10,4,3,15,15,50,False,1508,Northwestern
10,School Totals,200,20,48,.417,11,23,.478,9,25,.360,9,11,.818,6,23,29,12,2,4,10,17,58,False,3670,Northwestern
10,School Totals,225,28,66,.424,17,43,.395,11,23,.478,6,12,.500,8,17,25,18,2,1,4,25,73,False,2467,Northwestern
11,School Totals,200,19,59,.322,14,38,.368,5,21,.238,11,15,.733,5,25,30,16,0,5,10,14,54,False,1142,Northwestern
10,School Totals,200,27,58,.466,25,44,.568,2,14,.143,5,10,.500,4,24,28,11,2,4,11,16,61,False,2150,Northwestern
10,School Totals,200,27,63,.429,20,45,.444,7,18,.389,6,8,.750,6,25,31,10,3,5,5,18,67,False,748,Northwestern
12,School Totals,200,24,62,.387,21,44,.477,3,18,.167,6,13,.462,4,22,26,16,2,2,7,14,57,False,3246,Northwestern
10,School Totals,200,25,61,.410,20,41,.488,5,20,.250,11,16,.688,7,19,26,11,3,3,5,16,66,False,2747,Northwestern
10,School Totals,225,31,67,.463,27,50,.540,4,17,.235,15,20,.750,9,33,42,13,11,8,20,21,81,False,3483,Northwestern
10,School Totals,200,17,54,.315,14,39,.359,3,15,.200,11,15,.733,6,25,31,14,2,5,11,17,48,False,3671,Northwestern
11,School Totals,200,26,56,.464,15,34,.441,11,22,.500,17,23,.739,6,31,37,18,4,4,8,17,80,False,2154,Northwestern
10,School Totals,200,23,56,.411,18,38,.474,5,18,.278,6,8,.750,4,24,28,11,2,7,8,11,57,False,3249,Northwestern
15,School Totals,200,32,62,.516,18,33,.545,14,29,.483,14,23,.609,6,40,46,25,3,5,11,22,92,False,3672,Northwestern
15,School Totals,200,36,70,.514,25,46,.543,11,24,.458,28,37,.757,13,40,53,28,6,1,9,15,111,False,3673,Northwestern
10,School Totals,200,21,57,.368,13,29,.448,8,28,.286,20,27,.741,4,30,34,15,5,5,11,20,70,False,3674,Northwestern
15,School Totals,200,34,76,.447,20,47,.426,14,29,.483,18,24,.750,20,30,50,20,5,5,7,15,100,False,3675,Northwestern
10,School Totals,200,27,51,.529,17,30,.567,10,21,.476,15,18,.833,3,27,30,16,7,0,12,14,79,False,1522,Northwestern
10,School Totals,200,28,50,.560,21,31,.677,7,19,.368,11,13,.846,4,20,24,13,10,1,15,17,74,False,375,Northwestern
10,School Totals,200,28,58,.483,22,42,.524,6,16,.375,9,14,.643,4,20,24,24,7,5,5,14,71,False,1859,Northwestern
10,School Totals,200,26,59,.441,15,34,.441,11,25,.440,9,12,.750,8,22,30,15,5,2,11,17,72,False,3017,Northwestern
11,School Totals,200,26,63,.413,21,45,.467,5,18,.278,9,12,.750,5,21,26,12,1,1,8,14,66,False,1155,Northwestern
11,School Totals,200,18,55,.327,12,35,.343,6,20,.300,14,18,.778,6,19,25,13,10,0,13,16,56,False,2757,Northwestern
10,School Totals,200,25,63,.397,19,40,.475,6,23,.261,15,21,.714,6,25,31,9,5,1,4,21,71,False,1863,Northwestern
11,School Totals,200,27,65,.415,18,32,.563,9,33,.273,10,14,.714,6,20,26,19,3,2,6,22,73,False,3019,Northwestern
12,School Totals,200,21,51,.412,14,28,.500,7,23,.304,3,7,.429,2,23,25,10,3,2,10,17,52,False,3676,Northwestern
10,School Totals,200,29,59,.492,18,33,.545,11,26,.423,9,12,.750,3,20,23,16,8,2,14,20,78,False,2163,Northwestern
10,School Totals,200,20,48,.417,16,28,.571,4,20,.200,12,17,.706,6,22,28,10,9,0,18,22,56,False,2479,Northwestern
10,School Totals,200,26,59,.441,16,31,.516,10,28,.357,8,11,.727,6,22,28,16,3,3,14,22,70,False,3677,Northwestern
10,School Totals,250,29,68,.426,19,38,.500,10,30,.333,8,12,.667,5,27,32,16,8,7,11,26,76,False,386,Northwestern
9,School Totals,200,18,55,.327,12,36,.333,6,19,.316,8,12,.667,4,21,25,9,8,7,11,14,50,False,2482,Northwestern
10,School Totals,200,27,64,.422,21,39,.538,6,25,.240,6,8,.750,6,24,30,4,6,1,12,22,66,False,2761,Northwestern
12,School Totals,200,20,50,.400,14,30,.467,6,20,.300,5,8,.625,3,22,25,13,4,4,14,12,51,False,3678,Northwestern
10,School Totals,200,19,45,.422,12,27,.444,7,18,.389,22,27,.815,8,24,32,8,8,1,17,13,67,False,3261,Northwestern
10,School Totals,200,20,55,.364,10,26,.385,10,29,.345,10,11,.909,8,23,31,11,7,3,11,12,60,False,778,Northwestern
11,School Totals,200,32,60,.533,21,35,.600,11,25,.440,4,9,.444,6,21,27,21,8,3,12,16,79,False,3494,Northwestern
11,School Totals,200,18,58,.310,13,40,.325,5,18,.278,5,12,.417,7,29,36,9,9,2,14,21,46,False,3263,Northwestern
16,School Totals,200,30,66,.455,21,42,.500,9,24,.375,20,30,.667,9,25,34,24,8,6,13,31,89,False,3679,Purdue
11,School Totals,200,30,65,.462,28,51,.549,2,14,.143,12,21,.571,10,22,32,14,5,7,13,23,74,False,3680,Purdue
16,School Totals,200,30,71,.423,22,47,.468,8,24,.333,17,20,.850,10,24,34,21,11,3,9,22,85,False,3681,Purdue
11,School Totals,200,25,56,.446,21,40,.525,4,16,.250,19,26,.731,8,22,30,12,6,5,12,25,73,False,3682,Purdue
12,School Totals,200,20,44,.455,15,28,.536,5,16,.313,19,20,.950,12,19,31,9,5,5,17,17,64,False,3683,Purdue
11,School Totals,200,22,64,.344,21,49,.429,1,15,.067,24,31,.774,12,25,37,12,14,5,9,23,69,False,3684,Purdue
16,School Totals,200,36,69,.522,24,45,.533,12,24,.500,17,22,.773,10,27,37,22,10,7,12,18,101,False,3685,Purdue
16,School Totals,200,29,55,.527,19,33,.576,10,22,.455,18,23,.783,10,16,26,20,10,4,11,16,86,False,3686,Purdue
11,School Totals,200,25,54,.463,19,35,.543,6,19,.316,17,21,.810,12,22,34,9,5,2,17,19,73,False,3687,Purdue
16,School Totals,200,25,62,.403,21,39,.538,4,23,.174,15,20,.750,9,19,28,14,8,7,9,21,69,False,3688,Purdue
16,School Totals,200,37,81,.457,30,57,.526,7,24,.292,9,14,.643,22,21,43,21,10,10,6,12,90,False,3689,Purdue
11,School Totals,200,26,53,.491,22,42,.524,4,11,.364,11,18,.611,8,21,29,11,9,4,7,17,67,False,2780,Purdue
11,School Totals,200,28,56,.500,24,44,.545,4,12,.333,17,23,.739,9,16,25,11,9,2,7,18,77,False,3690,Purdue
11,School Totals,200,23,44,.523,17,27,.630,6,17,.353,27,36,.750,5,28,33,12,9,9,17,21,79,False,3038,Purdue
11,School Totals,200,25,53,.472,22,43,.512,3,10,.300,13,24,.542,3,27,30,11,3,3,10,25,66,False,3691,Purdue
10,School Totals,200,24,56,.429,14,29,.483,10,27,.370,8,12,.667,10,16,26,15,7,3,14,14,66,False,1552,Purdue
11,School Totals,200,21,60,.350,16,37,.432,5,23,.217,17,19,.895,8,12,20,11,6,6,6,25,64,False,3508,Purdue
12,School Totals,200,27,56,.482,24,40,.600,3,16,.188,27,34,.794,10,25,35,12,4,3,14,22,84,False,2503,Purdue
12,School Totals,200,25,50,.500,21,37,.568,4,13,.308,15,20,.750,8,22,30,19,9,2,11,15,69,False,800,Purdue
12,School Totals,200,24,49,.490,22,44,.500,2,5,.400,10,15,.667,11,23,34,11,5,3,13,16,60,False,3692,Purdue
13,School Totals,200,24,52,.462,16,36,.444,8,16,.500,10,16,.625,6,24,30,18,7,6,6,14,66,False,1894,Purdue
11,School Totals,200,26,56,.464,20,37,.541,6,19,.316,20,28,.714,13,22,35,13,3,6,9,18,78,False,20,Purdue
12,School Totals,202,25,44,.568,19,30,.633,6,14,.429,20,22,.909,3,24,27,16,5,4,14,23,76,False,1195,Purdue
13,School Totals,200,23,52,.442,21,40,.525,2,12,.167,15,20,.750,7,25,32,13,10,6,8,10,63,False,2784,Purdue
10,School Totals,200,24,48,.500,19,35,.543,5,13,.385,7,10,.700,3,23,26,15,2,2,16,16,60,False,1561,Purdue
11,School Totals,200,21,59,.356,12,41,.293,9,18,.500,24,28,.857,12,20,32,11,7,4,5,12,75,False,2507,Purdue
11,School Totals,200,24,53,.453,17,33,.515,7,20,.350,4,9,.444,6,23,29,19,2,4,7,19,59,False,3042,Purdue
11,School Totals,200,15,50,.300,13,41,.317,2,9,.222,12,18,.667,3,13,16,9,7,0,12,14,44,False,1198,Purdue
13,School Totals,200,24,49,.490,19,36,.528,5,13,.385,21,31,.677,3,21,24,16,7,6,8,11,74,False,28,Purdue
9,School Totals,200,22,45,.489,15,25,.600,7,20,.350,13,21,.619,7,22,29,11,8,3,12,16,64,False,1898,Purdue
10,School Totals,200,18,51,.353,14,35,.400,4,16,.250,29,39,.744,15,15,30,12,3,5,9,24,69,False,3511,Purdue
14,School Totals,200,16,58,.276,14,44,.318,2,14,.143,8,18,.444,5,15,20,5,7,1,10,21,42,False,3043,Purdue
11,School Totals,200,27,59,.458,22,42,.524,5,17,.294,13,19,.684,6,31,37,21,8,7,13,14,72,False,3693,Purdue
11,School Totals,225,26,63,.413,20,46,.435,6,17,.353,5,6,.833,3,27,30,11,12,6,12,18,63,False,3694,Purdue
11,School Totals,200,20,54,.370,16,39,.410,4,15,.267,13,21,.619,4,18,22,12,7,6,7,21,57,False,3695,Purdue
14,School Totals,200,25,58,.431,12,30,.400,13,28,.464,13,22,.591,12,33,45,21,4,9,11,19,76,False,3696,Purdue
14,School Totals,200,41,79,.519,34,60,.567,7,19,.368,14,21,.667,17,34,51,30,13,2,14,19,103,False,3697,Purdue
11,School Totals,200,33,65,.508,22,40,.550,11,25,.440,5,9,.556,11,15,26,22,14,4,13,16,82,False,3698,Purdue
14,School Totals,200,32,69,.464,23,41,.561,9,28,.321,14,24,.583,16,21,37,24,11,2,9,17,87,False,3699,Purdue
12,School Totals,200,25,57,.439,20,44,.455,5,13,.385,24,30,.800,12,18,30,8,4,3,14,24,79,False,3700,Purdue
12,School Totals,200,16,53,.302,12,37,.324,4,16,.250,18,25,.720,7,24,31,6,1,3,11,19,54,False,3701,Purdue
11,School Totals,225,21,58,.362,16,37,.432,5,21,.238,11,19,.579,8,20,28,12,4,2,9,20,58,False,3702,Purdue
11,School Totals,200,22,56,.393,13,32,.406,9,24,.375,13,14,.929,9,21,30,13,5,5,11,13,66,False,3703,Purdue
13,School Totals,200,28,54,.519,22,42,.524,6,12,.500,14,22,.636,6,27,33,16,9,5,14,22,76,False,3704,Purdue
13,School Totals,200,29,52,.558,23,37,.622,6,15,.400,13,24,.542,12,22,34,22,6,4,19,19,77,False,3705,Purdue
10,School Totals,200,19,57,.333,16,41,.390,3,16,.188,24,30,.800,8,26,34,12,5,6,7,20,65,False,3706,Purdue
13,School Totals,200,31,58,.534,21,36,.583,10,22,.455,5,7,.714,7,23,30,26,11,3,11,14,77,False,3707,Purdue
13,School Totals,200,29,59,.492,19,41,.463,10,18,.556,12,15,.800,9,24,33,19,5,4,8,15,80,False,826,Purdue
9,School Totals,200,25,54,.463,16,30,.533,9,24,.375,23,33,.697,12,23,35,18,5,3,10,16,82,False,3523,Purdue
9,School Totals,200,26,55,.473,20,42,.476,6,13,.462,25,41,.610,13,30,43,14,4,6,12,23,83,False,1910,Purdue
13,School Totals,200,30,61,.492,22,40,.550,8,21,.381,7,9,.778,10,25,35,21,6,9,12,15,75,False,2800,Purdue
10,School Totals,200,23,60,.383,15,37,.405,8,23,.348,13,13,1.000,15,19,34,18,3,3,8,17,67,False,3058,Purdue
11,School Totals,200,28,58,.483,25,47,.532,3,11,.273,5,7,.714,7,21,28,12,7,3,12,22,64,False,3708,Purdue
10,School Totals,200,24,54,.444,18,39,.462,6,15,.400,9,10,.900,5,9,14,18,6,2,3,13,63,False,1912,Purdue
11,School Totals,200,29,50,.580,23,38,.605,6,12,.500,22,30,.733,5,19,24,14,5,4,9,9,86,False,1223,Purdue
12,School Totals,200,24,63,.381,18,47,.383,6,16,.375,10,13,.769,7,19,26,11,6,5,10,23,64,False,1587,Purdue
10,School Totals,200,23,53,.434,13,30,.433,10,23,.435,17,22,.773,14,21,35,15,4,4,10,18,73,False,3060,Purdue
11,School Totals,200,23,48,.479,18,35,.514,5,13,.385,8,9,.889,4,19,23,10,6,5,13,19,59,False,3709,Purdue
10,School Totals,200,20,49,.408,16,37,.432,4,12,.333,23,28,.821,7,27,34,13,8,8,11,15,67,False,55,Purdue
11,School Totals,200,25,60,.417,18,40,.450,7,20,.350,24,31,.774,11,26,37,14,5,3,11,21,81,False,2532,Purdue
10,School Totals,200,24,56,.429,19,40,.475,5,16,.313,17,19,.895,9,17,26,11,4,5,4,13,70,False,3710,Purdue
12,School Totals,200,28,55,.509,21,35,.600,7,20,.350,13,18,.722,8,19,27,16,9,4,14,23,76,False,1591,Purdue
11,School Totals,200,25,50,.500,17,27,.630,8,23,.348,14,24,.583,11,23,34,16,6,2,10,21,72,False,58,Purdue
11,School Totals,200,25,57,.439,18,38,.474,7,19,.368,10,15,.667,8,25,33,14,7,7,9,15,67,False,1230,Purdue
9,School Totals,200,25,58,.431,14,32,.438,11,26,.423,14,19,.737,8,22,30,16,5,4,7,15,75,False,2534,Purdue
11,School Totals,200,25,69,.362,20,44,.455,5,25,.200,10,17,.588,10,22,32,13,9,2,7,21,65,False,2806,Purdue
10,School Totals,200,19,51,.373,16,35,.457,3,16,.188,15,25,.600,2,23,25,11,4,1,4,20,56,False,1233,Purdue
12,School Totals,200,23,54,.426,18,39,.462,5,15,.333,14,17,.824,9,31,40,12,7,3,16,13,65,False,3711,Purdue
10,School Totals,200,30,67,.448,22,42,.524,8,25,.320,8,11,.727,12,19,31,20,3,6,7,15,76,False,3712,Purdue
13,School Totals,200,31,67,.463,17,39,.436,14,28,.500,20,26,.769,9,25,34,23,14,6,9,13,96,False,3713,Purdue
10,School Totals,200,24,52,.462,11,20,.550,13,32,.406,6,19,.316,9,20,29,17,6,4,10,16,67,False,3714,Purdue
11,School Totals,200,34,76,.447,22,51,.431,12,25,.480,11,20,.550,12,29,41,15,10,2,7,22,91,False,3715,Purdue
11,School Totals,200,26,55,.473,20,39,.513,6,16,.375,27,33,.818,7,20,27,14,6,3,12,24,85,False,3716,Purdue
11,School Totals,200,20,57,.351,15,35,.429,5,22,.227,11,19,.579,13,22,35,11,5,3,8,17,56,False,3717,Purdue
13,School Totals,200,30,63,.476,22,44,.500,8,19,.421,12,17,.706,8,26,34,16,9,5,7,24,80,False,3718,Purdue
12,School Totals,200,30,66,.455,18,32,.563,12,34,.353,6,10,.600,15,19,34,20,4,7,5,14,78,False,3719,Purdue
11,School Totals,200,26,47,.553,22,31,.710,4,16,.250,20,29,.690,6,20,26,10,4,5,10,17,76,False,3720,Purdue
11,School Totals,200,23,56,.411,18,38,.474,5,18,.278,12,21,.571,10,13,23,9,13,1,13,25,63,False,3721,Purdue
11,School Totals,200,20,52,.385,14,34,.412,6,18,.333,19,36,.528,15,21,36,10,10,7,15,20,65,False,3722,Purdue
12,School Totals,200,20,55,.364,11,27,.407,9,28,.321,12,23,.522,15,22,37,14,8,5,7,13,61,False,3723,Purdue
11,School Totals,200,26,65,.400,20,44,.455,6,21,.286,7,12,.583,11,22,33,14,8,6,8,20,65,False,3724,Purdue
13,School Totals,200,32,60,.533,24,37,.649,8,23,.348,9,12,.750,12,26,38,17,6,2,13,20,81,False,3725,Purdue
11,School Totals,200,33,66,.500,27,46,.587,6,20,.300,7,11,.636,8,24,32,11,6,1,7,21,79,False,2820,Purdue
13,School Totals,200,25,44,.568,16,27,.593,9,17,.529,16,28,.571,3,21,24,15,10,0,13,16,75,False,2550,Purdue
13,School Totals,200,15,47,.319,9,24,.375,6,23,.261,9,12,.750,6,19,25,10,6,5,12,15,45,False,1937,Purdue
11,School Totals,200,30,55,.545,20,40,.500,10,15,.667,9,19,.474,5,21,26,12,9,6,10,17,79,False,3076,Purdue
11,School Totals,200,21,61,.344,13,37,.351,8,24,.333,12,22,.545,11,19,30,12,4,0,3,21,62,False,3726,Purdue
12,School Totals,200,23,56,.411,19,41,.463,4,15,.267,25,35,.714,14,23,37,12,7,3,10,23,75,False,2823,Purdue
14,School Totals,200,18,62,.290,15,42,.357,3,20,.150,19,24,.792,16,16,32,7,4,2,11,18,58,False,1253,Purdue
11,School Totals,200,23,52,.442,14,26,.538,9,26,.346,9,12,.750,6,15,21,16,6,5,9,14,64,False,866,Purdue
10,School Totals,200,24,54,.444,18,34,.529,6,20,.300,4,8,.500,5,14,19,10,7,3,5,18,58,False,3543,Purdue
12,School Totals,200,21,71,.296,16,50,.320,5,21,.238,14,20,.700,13,17,30,8,7,8,3,25,61,False,86,Purdue
11,School Totals,200,28,54,.519,17,35,.486,11,19,.579,17,25,.680,5,16,21,10,5,1,3,25,84,False,1620,Purdue
10,School Totals,200,26,61,.426,15,38,.395,11,23,.478,24,33,.727,13,25,38,20,3,2,5,20,87,False,3544,Purdue
9,School Totals,200,27,60,.450,20,44,.455,7,16,.438,6,10,.600,10,21,31,14,3,2,11,13,67,False,2556,Purdue
11,School Totals,200,22,65,.338,16,43,.372,6,22,.273,12,18,.667,9,18,27,11,4,4,6,16,62,False,1259,Purdue
13,School Totals,200,30,55,.545,17,26,.654,13,29,.448,10,15,.667,8,19,27,19,8,3,7,8,83,False,3343,Purdue
11,School Totals,200,27,54,.500,20,39,.513,7,15,.467,14,16,.875,5,23,28,12,5,2,5,8,75,False,873,Purdue
13,School Totals,200,27,47,.574,18,25,.720,9,22,.409,17,21,.810,8,21,29,21,3,2,13,14,80,False,1947,Purdue
9,School Totals,200,28,64,.438,20,43,.465,8,21,.381,10,13,.769,7,20,27,11,8,1,10,22,74,False,93,Purdue
13,School Totals,200,28,50,.560,15,25,.600,13,25,.520,10,18,.556,5,23,28,17,4,0,10,14,79,False,3344,Purdue
11,School Totals,200,25,63,.397,13,37,.351,12,26,.462,9,15,.600,6,17,23,14,4,1,5,12,71,False,1625,Purdue
9,School Totals,200,26,57,.456,21,41,.512,5,16,.313,15,18,.833,4,21,25,7,7,2,10,17,72,False,3727,Purdue
10,School Totals,200,20,50,.400,12,32,.375,8,18,.444,12,19,.632,10,22,32,11,3,1,10,16,60,False,3728,Purdue
12,School Totals,200,28,61,.459,26,45,.578,2,16,.125,7,15,.467,9,22,31,16,4,4,9,20,65,False,3729,Purdue
15,School Totals,200,33,64,.516,26,46,.565,7,18,.389,10,13,.769,19,28,47,21,8,4,20,20,83,False,3730,Purdue
13,School Totals,225,30,77,.390,25,54,.463,5,23,.217,16,28,.571,16,29,45,19,9,7,16,33,81,False,3731,Purdue
13,School Totals,200,22,65,.338,17,46,.370,5,19,.263,9,16,.563,17,17,34,14,7,7,11,20,58,False,3732,Purdue
15,School Totals,200,21,49,.429,17,36,.472,4,13,.308,20,24,.833,12,25,37,12,10,4,16,12,66,False,3733,Purdue
11,School Totals,200,25,49,.510,17,31,.548,8,18,.444,15,21,.714,9,29,38,15,3,3,13,19,73,False,3734,Purdue
11,School Totals,200,21,60,.350,21,43,.488,0,17,.000,15,23,.652,15,23,38,7,2,1,11,15,57,False,3735,Purdue
15,School Totals,200,28,62,.452,24,51,.471,4,11,.364,12,21,.571,17,31,48,13,8,7,12,15,72,False,3736,Purdue
12,School Totals,200,14,47,.298,10,33,.303,4,14,.286,12,20,.600,13,31,44,9,2,6,18,19,44,False,3737,Purdue
12,School Totals,200,25,61,.410,21,49,.429,4,12,.333,14,19,.737,7,19,26,10,5,0,15,24,68,False,3738,Purdue
12,School Totals,200,23,52,.442,20,44,.455,3,8,.375,17,25,.680,7,23,30,13,6,5,9,22,66,False,3739,Purdue
10,School Totals,200,28,62,.452,25,50,.500,3,12,.250,14,19,.737,9,22,31,17,5,6,7,11,73,False,3740,Purdue
10,School Totals,200,25,61,.410,19,45,.422,6,16,.375,12,19,.632,12,26,38,14,3,7,10,14,68,False,2575,Purdue
14,School Totals,200,24,61,.393,20,47,.426,4,14,.286,9,20,.450,10,23,33,11,4,4,10,21,61,False,1283,Purdue
11,School Totals,200,26,67,.388,23,59,.390,3,8,.375,9,14,.643,10,17,27,13,6,2,6,17,64,False,1645,Purdue
14,School Totals,200,23,51,.451,19,43,.442,4,8,.500,10,21,.476,8,27,35,13,4,6,14,15,60,False,1962,Purdue
11,School Totals,200,25,56,.446,19,41,.463,6,15,.400,9,16,.563,11,30,41,15,1,8,12,11,65,False,3359,Purdue
14,School Totals,200,29,59,.492,21,48,.438,8,11,.727,13,21,.619,15,24,39,17,6,7,16,21,79,False,3741,Purdue
11,School Totals,200,21,54,.389,14,32,.438,7,22,.318,4,7,.571,8,17,25,12,2,3,12,14,53,False,897,Purdue
10,School Totals,225,25,64,.391,22,52,.423,3,12,.250,12,20,.600,11,32,43,13,4,8,7,21,65,False,2847,Purdue
12,School Totals,200,22,55,.400,20,47,.426,2,8,.250,14,19,.737,10,13,23,11,2,8,18,17,60,False,119,Purdue
12,School Totals,200,23,69,.333,19,58,.328,4,11,.364,10,16,.625,17,22,39,16,2,3,8,17,60,False,3559,Purdue
11,School Totals,200,20,49,.408,20,39,.513,0,10,.000,18,29,.621,6,34,40,8,3,5,10,14,58,False,1965,Purdue
11,School Totals,200,21,44,.477,20,39,.513,1,5,.200,22,34,.647,8,18,26,14,4,4,14,19,65,False,1291,Purdue
11,School Totals,200,21,55,.382,15,39,.385,6,16,.375,11,16,.688,11,18,29,9,8,4,17,12,59,False,2582,Purdue
13,School Totals,200,21,56,.375,17,45,.378,4,11,.364,9,14,.643,9,16,25,7,6,6,17,23,55,False,124,Purdue
14,School Totals,200,27,51,.529,20,36,.556,7,15,.467,13,23,.565,9,32,41,18,6,5,15,18,74,False,3561,Purdue
12,School Totals,200,19,52,.365,16,38,.421,3,14,.214,7,10,.700,8,26,34,14,4,0,15,24,48,False,2853,Purdue
11,School Totals,200,26,57,.456,20,45,.444,6,12,.500,11,17,.647,10,26,36,15,8,2,12,12,69,False,3742,Purdue
11,School Totals,200,26,60,.433,21,45,.467,5,15,.333,18,21,.857,12,26,38,15,3,3,13,22,75,False,907,Purdue
13,School Totals,200,32,59,.542,25,44,.568,7,15,.467,18,24,.750,7,19,26,20,6,4,8,15,89,False,3108,Purdue
9,School Totals,200,23,57,.404,21,45,.467,2,12,.167,7,14,.500,10,23,33,13,1,5,7,14,55,False,3362,Purdue
15,School Totals,200,31,53,.585,24,42,.571,7,11,.636,12,13,.923,7,18,25,19,7,3,12,13,81,False,3743,Purdue
11,School Totals,200,30,69,.435,29,58,.500,1,11,.091,22,28,.786,13,21,34,15,9,2,11,22,83,False,3744,Purdue
11,School Totals,200,27,58,.466,20,43,.465,7,15,.467,16,20,.800,15,17,32,12,6,4,12,15,77,False,3745,Purdue
16,School Totals,200,43,79,.544,34,55,.618,9,24,.375,14,24,.583,19,29,48,22,6,13,9,18,109,False,3746,Purdue
12,School Totals,200,31,61,.508,28,46,.609,3,15,.200,16,31,.516,13,17,30,15,9,5,9,27,81,False,3747,Purdue
16,School Totals,200,28,61,.459,24,41,.585,4,20,.200,23,34,.676,11,29,40,16,12,7,10,20,83,False,3748,Purdue
12,School Totals,200,27,63,.429,22,47,.468,5,16,.313,22,37,.595,13,29,42,11,6,12,15,19,81,False,3749,Purdue
12,School Totals,200,29,68,.426,19,48,.396,10,20,.500,19,30,.633,14,23,37,15,4,2,12,31,87,False,3750,Purdue
12,School Totals,200,19,57,.333,13,40,.325,6,17,.353,10,12,.833,12,21,33,8,4,6,15,18,54,False,3751,Purdue
11,School Totals,200,22,53,.415,19,40,.475,3,13,.231,21,26,.808,7,22,29,6,7,9,11,18,68,False,3752,Purdue
16,School Totals,200,36,69,.522,29,55,.527,7,14,.500,9,15,.600,13,24,37,20,6,4,8,19,88,False,3753,Purdue
11,School Totals,200,20,50,.400,14,29,.483,6,21,.286,23,38,.605,13,15,28,13,10,5,14,21,69,False,3754,Purdue
12,School Totals,200,28,63,.444,24,49,.490,4,14,.286,10,15,.667,13,21,34,9,8,5,18,25,70,False,3755,Purdue
16,School Totals,200,29,58,.500,21,42,.500,8,16,.500,13,16,.813,11,26,37,20,10,4,10,16,79,False,3756,Purdue
12,School Totals,200,25,60,.417,18,42,.429,7,18,.389,16,26,.615,12,30,42,11,2,6,11,25,73,False,3757,Purdue
11,School Totals,200,28,67,.418,25,53,.472,3,14,.214,10,16,.625,15,30,45,14,2,6,12,19,69,False,1673,Purdue
12,School Totals,200,25,63,.397,16,42,.381,9,21,.429,20,28,.714,17,15,32,15,8,3,8,20,79,False,3124,Purdue
12,School Totals,200,24,52,.462,19,39,.487,5,13,.385,17,28,.607,6,30,36,15,4,5,11,15,70,False,3375,Purdue
12,School Totals,200,26,62,.419,22,43,.512,4,19,.211,10,12,.833,12,24,36,9,6,4,9,17,66,False,2604,Purdue
12,School Totals,200,18,57,.316,11,35,.314,7,22,.318,22,30,.733,16,25,41,11,5,8,16,20,65,False,1987,Purdue
11,School Totals,250,16,58,.276,8,37,.216,8,21,.381,20,29,.690,7,30,37,10,3,6,14,18,60,False,3576,Purdue
12,School Totals,200,23,65,.354,20,48,.417,3,17,.176,9,13,.692,12,22,34,13,3,3,8,24,58,False,3758,Purdue
12,School Totals,200,28,65,.431,26,51,.510,2,14,.143,8,15,.533,15,16,31,12,8,1,11,19,66,False,935,Purdue
13,School Totals,200,25,59,.424,22,48,.458,3,11,.273,15,20,.750,9,21,30,12,5,3,14,29,68,False,1989,Purdue
11,School Totals,275,31,73,.425,25,55,.455,6,18,.333,9,23,.391,20,27,47,22,8,9,15,14,77,False,3128,Purdue
11,School Totals,200,21,50,.420,16,37,.432,5,13,.385,2,5,.400,10,23,33,10,3,3,15,17,49,False,1682,Purdue
16,School Totals,200,25,52,.481,15,34,.441,10,18,.556,22,29,.759,8,29,37,13,8,7,14,23,82,False,159,Purdue
12,School Totals,200,24,49,.490,17,35,.486,7,14,.500,24,40,.600,9,15,24,12,8,1,10,18,79,False,1324,Purdue
14,School Totals,200,16,53,.302,13,37,.351,3,16,.188,22,29,.759,9,30,39,5,3,6,14,23,57,False,3377,Purdue
10,School Totals,225,26,63,.413,19,39,.487,7,24,.292,17,18,.944,12,22,34,15,3,4,11,17,76,False,941,Purdue
10,School Totals,199,28,57,.491,22,39,.564,6,18,.333,14,21,.667,9,28,37,15,1,4,15,25,76,False,2880,Purdue
10,School Totals,200,29,64,.453,26,50,.520,3,14,.214,9,14,.643,11,21,32,11,4,4,11,25,70,False,3759,Purdue
10,School Totals,200,21,59,.356,17,41,.415,4,18,.222,19,23,.826,10,30,40,14,1,2,11,25,65,False,3578,Purdue
10,School Totals,200,24,58,.414,22,48,.458,2,10,.200,11,16,.688,11,24,35,13,6,7,16,21,61,False,1687,Purdue
15,School Totals,200,26,47,.553,17,26,.654,9,21,.429,19,31,.613,6,35,41,21,6,9,15,16,80,False,3760,Purdue
12,School Totals,200,25,50,.500,17,33,.515,8,17,.471,19,31,.613,9,17,26,14,9,8,15,18,77,False,3761,Purdue
15,School Totals,200,31,63,.492,22,38,.579,9,25,.360,11,17,.647,15,25,40,24,11,3,13,16,82,False,3762,Purdue
12,School Totals,200,28,51,.549,19,29,.655,9,22,.409,14,20,.700,5,18,23,19,3,5,12,20,79,False,3763,Purdue
14,School Totals,200,22,47,.468,17,33,.515,5,14,.357,33,43,.767,13,26,39,12,6,8,15,20,82,False,3764,Purdue
11,School Totals,225,27,59,.458,22,42,.524,5,17,.294,28,36,.778,9,22,31,14,6,8,16,23,87,False,3765,Purdue
10,School Totals,200,22,56,.393,15,36,.417,7,20,.350,15,22,.682,15,21,36,16,3,2,10,17,66,False,3766,Purdue
11,School Totals,200,29,74,.392,25,55,.455,4,19,.211,8,16,.500,21,25,46,18,8,6,14,22,70,False,3767,Purdue
11,School Totals,200,25,58,.431,20,41,.488,5,17,.294,8,11,.727,12,26,38,18,6,10,13,16,63,False,3768,Purdue
15,School Totals,200,30,59,.508,21,36,.583,9,23,.391,18,28,.643,11,25,36,21,5,8,10,12,87,False,3769,Purdue
11,School Totals,201,26,55,.473,23,44,.523,3,11,.273,16,23,.696,12,15,27,7,5,5,12,23,71,False,3770,Purdue
11,School Totals,200,24,61,.393,20,47,.426,4,14,.286,11,15,.733,2,26,28,14,3,4,12,24,63,False,3771,Purdue
11,School Totals,200,32,68,.471,28,53,.528,4,15,.267,16,21,.762,17,22,39,14,9,4,12,20,84,False,3772,Purdue
11,School Totals,200,23,52,.442,19,41,.463,4,11,.364,22,27,.815,10,21,31,20,3,3,12,17,72,False,3150,Purdue
10,School Totals,200,21,46,.457,18,33,.545,3,13,.231,17,29,.586,11,31,42,12,7,3,13,17,64,False,964,Purdue
10,School Totals,200,25,49,.510,23,44,.523,2,5,.400,3,7,.429,3,18,21,10,3,0,12,24,55,False,3773,Purdue
11,School Totals,200,21,57,.368,16,37,.432,5,20,.250,13,20,.650,11,23,34,13,5,4,14,25,60,False,578,Purdue
11,School Totals,225,28,58,.483,18,33,.545,10,25,.400,18,29,.621,10,18,28,18,8,5,16,20,84,False,2014,Purdue
11,School Totals,200,24,60,.400,19,39,.487,5,21,.238,4,9,.444,9,21,30,12,4,5,10,18,57,False,2628,Purdue
10,School Totals,200,25,53,.472,21,33,.636,4,20,.200,13,23,.565,8,20,28,19,3,8,5,17,67,False,2899,Purdue
14,School Totals,200,27,46,.587,23,32,.719,4,14,.286,25,33,.758,8,23,31,13,6,10,12,20,83,False,187,Purdue
10,School Totals,200,21,45,.467,19,36,.528,2,9,.222,24,32,.750,7,25,32,16,5,1,8,12,68,False,3593,Purdue
10,School Totals,200,19,45,.422,16,33,.485,3,12,.250,19,27,.704,10,21,31,10,7,9,13,16,60,False,1708,Purdue
11,School Totals,200,22,51,.431,11,25,.440,11,26,.423,3,5,.600,9,26,35,16,3,7,23,18,58,False,3153,Purdue
10,School Totals,200,21,52,.404,18,37,.486,3,15,.200,16,23,.696,8,20,28,7,9,5,12,19,61,False,2351,Purdue
10,School Totals,200,20,52,.385,12,31,.387,8,21,.381,18,30,.600,15,25,40,15,6,3,11,11,66,False,3396,Purdue
11,School Totals,200,24,52,.462,22,34,.647,2,18,.111,17,21,.810,11,24,35,12,6,5,15,17,67,False,193,Purdue
10,School Totals,200,31,56,.554,24,41,.585,7,15,.467,23,36,.639,9,26,35,21,5,6,12,24,92,False,2353,Purdue
10,School Totals,200,23,52,.442,15,34,.441,8,18,.444,7,13,.538,9,21,30,12,4,4,14,23,61,False,1712,Purdue
10,School Totals,200,24,53,.453,14,32,.438,10,21,.476,8,12,.667,8,23,31,15,6,6,12,24,66,False,1358,Purdue
11,School Totals,200,18,44,.409,12,26,.462,6,18,.333,21,26,.808,9,27,36,13,7,2,20,20,63,False,2634,Purdue
10,School Totals,200,18,46,.391,12,26,.462,6,20,.300,22,30,.733,11,26,37,14,0,7,9,19,64,False,2025,Purdue
10,School Totals,200,19,51,.373,12,37,.324,7,14,.500,6,6,1.000,7,16,23,12,3,3,9,15,51,False,3774,Purdue
10,School Totals,225,26,72,.361,22,46,.478,4,26,.154,9,15,.600,19,30,49,13,5,1,12,18,65,False,3775,Purdue
13,School Totals,200,24,53,.453,12,22,.545,12,31,.387,21,32,.656,12,33,45,21,4,8,13,22,81,False,3776,Purdue
13,School Totals,200,36,65,.554,18,29,.621,18,36,.500,17,27,.630,7,25,32,24,7,4,5,24,107,False,3777,Purdue
14,School Totals,200,34,57,.596,25,36,.694,9,21,.429,19,22,.864,11,40,51,23,7,13,22,17,96,False,3778,Purdue
12,School Totals,200,23,56,.411,17,36,.472,6,20,.300,9,12,.750,12,30,42,8,4,4,11,12,61,False,3779,Purdue
11,School Totals,200,30,60,.500,19,34,.559,11,26,.423,14,20,.700,10,26,36,15,3,4,13,14,85,False,3780,Purdue
13,School Totals,200,26,60,.433,22,41,.537,4,19,.211,21,25,.840,11,36,47,16,1,7,12,17,77,False,3781,Purdue
10,School Totals,200,24,55,.436,13,27,.481,11,28,.393,13,18,.722,12,24,36,19,5,0,12,20,72,False,3782,Purdue
10,School Totals,200,23,62,.371,20,41,.488,3,21,.143,21,28,.750,12,32,44,13,8,4,19,20,70,False,3783,Purdue
13,School Totals,200,28,54,.519,21,32,.656,7,22,.318,17,21,.810,6,28,34,20,10,9,12,16,80,False,3784,Purdue
14,School Totals,200,34,68,.500,22,37,.595,12,31,.387,13,17,.765,12,30,42,28,5,4,6,18,93,False,3785,Purdue
14,School Totals,200,33,60,.550,23,39,.590,10,21,.476,19,28,.679,8,33,41,26,3,6,10,13,95,False,3786,Purdue
11,School Totals,200,24,58,.414,17,36,.472,7,22,.318,13,16,.813,7,30,37,14,4,9,18,23,68,False,3787,Purdue
11,School Totals,200,21,58,.362,19,39,.487,2,19,.105,24,31,.774,13,29,42,14,5,8,11,14,68,False,3788,Purdue
11,School Totals,200,22,50,.440,17,37,.459,5,13,.385,12,14,.857,6,28,34,12,4,2,16,11,61,False,3789,Purdue
11,School Totals,200,23,59,.390,15,34,.441,8,25,.320,9,15,.600,12,23,35,17,4,5,14,18,63,False,2919,Purdue
11,School Totals,200,30,54,.556,21,36,.583,9,18,.500,18,21,.857,5,30,35,26,5,7,9,13,87,False,996,Purdue
11,School Totals,200,27,60,.450,20,38,.526,7,22,.318,9,11,.818,9,21,30,15,3,1,16,28,70,False,2649,Purdue
11,School Totals,200,27,59,.458,19,38,.500,8,21,.381,12,19,.632,10,27,37,15,9,4,13,15,74,False,2040,Purdue
14,School Totals,200,39,80,.488,28,51,.549,11,29,.379,18,24,.750,24,35,59,19,5,3,4,13,107,False,2370,Purdue
11,School Totals,200,23,59,.390,19,42,.452,4,17,.235,25,31,.806,13,21,34,14,5,4,6,21,75,False,1735,Purdue
10,School Totals,200,27,64,.422,18,41,.439,9,23,.391,8,15,.533,11,25,36,15,8,2,17,24,71,False,2921,Purdue
9,School Totals,200,24,57,.421,19,41,.463,5,16,.313,15,19,.789,10,28,38,13,3,5,14,19,68,False,3171,Purdue
10,School Totals,200,33,56,.589,26,44,.591,7,12,.583,16,18,.889,9,27,36,27,2,5,14,13,89,False,3411,Purdue
10,School Totals,200,28,69,.406,25,44,.568,3,25,.120,2,5,.400,7,28,35,17,4,1,9,20,61,False,617,Purdue
12,School Totals,225,26,60,.433,18,44,.409,8,16,.500,22,29,.759,13,26,39,15,2,11,15,17,82,False,1388,Purdue
10,School Totals,200,21,53,.396,15,41,.366,6,12,.500,8,14,.571,7,27,34,8,2,3,9,18,56,False,1004,Purdue
11,School Totals,200,23,60,.383,19,47,.404,4,13,.308,21,28,.750,18,26,44,11,2,1,9,14,71,False,3609,Purdue
11,School Totals,200,27,46,.587,18,27,.667,9,19,.474,10,16,.625,3,22,25,19,1,2,13,16,73,False,228,Purdue
10,School Totals,200,31,60,.517,24,43,.558,7,17,.412,14,20,.700,17,22,39,16,3,2,15,17,83,False,622,Purdue
12,School Totals,200,30,53,.566,23,38,.605,7,15,.467,14,17,.824,5,29,34,22,3,6,8,19,81,False,3413,Purdue
13,School Totals,200,28,45,.622,18,26,.692,10,19,.526,25,33,.758,4,25,29,23,2,2,9,14,91,False,3790,Purdue
14,School Totals,200,35,60,.583,22,33,.667,13,27,.481,6,10,.600,7,31,38,25,3,4,10,18,89,False,2659,Purdue
11,School Totals,200,29,55,.527,25,43,.581,4,12,.333,14,18,.778,5,32,37,18,5,4,12,12,76,False,1010,Purdue
10,School Totals,200,21,55,.382,18,40,.450,3,15,.200,17,21,.810,5,22,27,10,4,4,5,14,62,False,1395,Purdue
10,School Totals,250,26,62,.419,17,34,.500,9,28,.321,22,28,.786,10,41,51,17,2,7,18,23,83,False,3791,Purdue
11,School Totals,200,39,70,.557,30,47,.638,9,23,.391,22,31,.710,19,37,56,23,7,4,14,10,109,False,3792,Purdue
9,School Totals,200,28,57,.491,20,35,.571,8,22,.364,12,19,.632,5,22,27,26,2,1,15,21,76,False,3793,Purdue
9,School Totals,200,17,45,.378,12,23,.522,5,22,.227,25,37,.676,6,19,25,11,6,1,14,16,64,False,3794,Purdue
12,School Totals,200,27,55,.491,16,35,.457,11,20,.550,20,27,.741,7,22,29,17,7,1,13,20,85,False,3795,Purdue
13,School Totals,200,36,56,.643,19,30,.633,17,26,.654,7,13,.538,7,28,35,20,6,1,21,20,96,False,3796,Purdue
10,School Totals,200,26,60,.433,17,31,.548,9,29,.310,18,20,.900,8,27,35,21,7,1,16,12,79,False,3797,Purdue
10,School Totals,200,19,53,.358,9,30,.300,10,23,.435,16,22,.727,9,25,34,13,6,1,17,19,64,False,3798,Purdue
12,School Totals,200,34,61,.557,19,32,.594,15,29,.517,7,14,.500,4,28,32,27,5,3,9,8,90,False,3799,Purdue
12,School Totals,200,38,64,.594,23,37,.622,15,27,.556,6,8,.750,9,29,38,26,3,4,15,19,97,False,3800,Purdue
12,School Totals,200,28,58,.483,19,34,.559,9,24,.375,12,18,.667,10,30,40,18,7,5,15,13,77,False,3801,Purdue
9,School Totals,200,30,66,.455,23,48,.479,7,18,.389,19,23,.826,13,26,39,19,4,5,9,13,86,False,3802,Purdue
12,School Totals,200,27,64,.422,22,46,.478,5,18,.278,23,30,.767,15,36,51,19,2,2,6,12,82,False,3803,Purdue
12,School Totals,200,35,63,.556,31,44,.705,4,19,.211,17,23,.739,12,31,43,21,6,4,11,13,91,False,3804,Purdue
12,School Totals,200,34,67,.507,22,38,.579,12,29,.414,9,10,.900,4,27,31,27,7,6,13,13,89,False,2940,Purdue
10,School Totals,225,30,75,.400,21,47,.447,9,28,.321,13,15,.867,14,27,41,17,1,0,14,16,82,False,3187,Purdue
10,School Totals,200,27,63,.429,19,40,.475,8,23,.348,14,20,.700,13,28,41,11,2,1,12,18,76,False,1760,Purdue
10,School Totals,200,24,46,.522,17,31,.548,7,15,.467,11,12,.917,6,25,31,16,3,4,18,15,66,False,3805,Purdue
9,School Totals,200,23,53,.434,12,25,.480,11,28,.393,21,25,.840,7,20,27,18,5,1,11,16,78,False,2942,Purdue
13,School Totals,200,32,53,.604,25,38,.658,7,15,.467,20,22,.909,2,29,31,22,1,5,10,20,91,False,2673,Purdue
13,School Totals,200,30,53,.566,22,33,.667,8,20,.400,9,15,.600,7,30,37,23,6,5,16,12,77,False,2066,Purdue
9,School Totals,200,26,53,.491,15,32,.469,11,21,.524,21,24,.875,11,24,35,21,4,0,13,14,84,False,1416,Purdue
9,School Totals,200,27,62,.435,13,38,.342,14,24,.583,12,13,.923,10,24,34,17,8,2,11,21,80,False,3430,Purdue
12,School Totals,200,24,50,.480,12,27,.444,12,23,.522,20,25,.800,8,32,40,17,4,3,12,20,80,False,3623,Purdue
9,School Totals,200,24,63,.381,15,41,.366,9,22,.409,16,19,.842,8,28,36,10,8,2,10,20,73,False,650,Purdue
9,School Totals,200,23,54,.426,17,33,.515,6,21,.286,17,24,.708,10,23,33,11,7,2,12,19,69,False,260,Purdue
12,School Totals,200,29,61,.475,21,34,.618,8,27,.296,8,13,.615,12,32,44,17,8,5,14,11,74,False,2399,Purdue
12,School Totals,200,27,53,.509,22,38,.579,5,15,.333,21,25,.840,1,24,25,18,5,1,10,12,80,False,1420,Purdue
9,School Totals,225,23,58,.397,11,32,.344,12,26,.462,16,19,.842,6,27,33,19,7,2,17,13,74,False,2072,Purdue
9,School Totals,200,30,61,.492,25,45,.556,5,16,.313,5,8,.625,10,19,29,9,4,1,10,16,70,False,1038,Purdue
9,School Totals,200,25,52,.481,17,34,.500,8,18,.444,28,33,.848,7,20,27,13,5,3,10,20,86,False,265,Purdue
9,School Totals,200,24,54,.444,20,35,.571,4,19,.211,17,19,.895,6,24,30,16,5,2,8,13,69,False,3625,Purdue
10,School Totals,225,28,61,.459,20,42,.476,8,19,.421,6,13,.462,9,26,35,17,9,2,15,19,70,False,1042,Purdue
9,School Totals,200,31,60,.517,22,40,.550,9,20,.450,9,14,.643,10,28,38,16,2,6,10,15,80,False,3806,Purdue
9,School Totals,200,31,64,.484,23,38,.605,8,26,.308,10,15,.667,8,29,37,27,6,1,10,15,80,False,3807,Purdue
12,School Totals,200,24,56,.429,14,29,.483,10,27,.370,8,12,.667,7,20,27,17,6,0,16,18,66,False,3808,Purdue
13,School Totals,200,36,61,.590,27,42,.643,9,19,.474,24,32,.750,10,24,34,24,8,8,11,15,105,False,3809,Purdue
13,School Totals,200,40,66,.606,28,38,.737,12,28,.429,19,28,.679,13,41,54,24,6,9,14,22,111,False,3810,Purdue
11,School Totals,200,32,56,.571,28,44,.636,4,12,.333,18,23,.783,6,26,32,19,5,5,10,18,86,False,3811,Purdue
13,School Totals,200,38,74,.514,19,43,.442,19,31,.613,11,17,.647,12,28,40,23,11,5,9,16,106,False,3812,Purdue
10,School Totals,225,22,59,.373,12,32,.375,10,27,.370,21,25,.840,7,29,36,13,7,4,17,16,75,False,3813,Purdue
10,School Totals,200,24,59,.407,16,32,.500,8,27,.296,17,20,.850,9,21,30,17,6,3,13,21,73,False,3814,Purdue
13,School Totals,200,31,54,.574,20,32,.625,11,22,.500,16,21,.762,6,26,32,19,6,7,14,19,89,False,3815,Purdue
11,School Totals,200,19,57,.333,14,34,.412,5,23,.217,23,32,.719,7,27,34,9,5,5,11,16,66,False,3816,Purdue
11,School Totals,200,27,53,.509,18,33,.545,9,20,.450,17,19,.895,6,27,33,17,4,7,9,23,80,False,669,Purdue
10,School Totals,200,26,53,.491,20,35,.571,6,18,.333,16,24,.667,9,22,31,15,2,5,7,9,74,False,3636,Purdue
13,School Totals,200,28,62,.452,21,41,.512,7,21,.333,17,24,.708,7,29,36,16,7,7,9,9,80,False,3817,Purdue
13,School Totals,200,31,57,.544,23,31,.742,8,26,.308,16,17,.941,6,23,29,20,11,3,13,11,86,False,3818,Purdue
9,School Totals,200,27,51,.529,18,30,.600,9,21,.429,19,24,.792,5,24,29,14,8,10,18,14,82,False,3819,Purdue
12,School Totals,200,34,58,.586,19,32,.594,15,26,.577,14,22,.636,4,28,32,25,9,8,9,15,97,False,3820,Purdue
12,School Totals,200,35,67,.522,23,40,.575,12,27,.444,16,22,.727,15,34,49,18,5,9,11,16,98,False,3821,Purdue
12,School Totals,200,26,53,.491,16,30,.533,10,23,.435,20,28,.714,10,34,44,13,2,5,16,18,82,False,2417,Purdue
11,School Totals,200,27,61,.443,21,40,.525,6,21,.286,14,18,.778,12,25,37,17,7,6,14,15,74,False,3446,Purdue
10,School Totals,200,27,57,.474,15,36,.417,12,21,.571,4,7,.571,8,21,29,14,5,3,8,14,70,False,1064,Purdue
11,School Totals,200,29,61,.475,15,26,.577,14,35,.400,9,10,.900,7,33,40,24,6,4,11,11,81,False,3208,Purdue
11,School Totals,200,30,58,.517,16,36,.444,14,22,.636,4,10,.400,4,19,23,20,14,7,9,12,78,False,3822,Purdue
12,School Totals,200,33,59,.559,13,26,.500,20,33,.606,1,4,.250,7,18,25,23,4,5,9,17,87,False,2962,Purdue
10,School Totals,200,31,50,.620,20,30,.667,11,20,.550,19,23,.826,4,14,18,22,7,6,10,11,92,False,1068,Purdue
10,School Totals,200,27,56,.482,22,38,.579,5,18,.278,15,18,.833,5,21,26,16,4,2,7,15,74,False,291,Purdue
10,School Totals,200,26,58,.448,19,36,.528,7,22,.318,16,23,.696,8,23,31,16,6,2,4,16,75,False,683,Purdue
10,School Totals,200,23,51,.451,16,30,.533,7,21,.333,25,29,.862,4,16,20,13,5,2,8,14,78,False,2422,Purdue
10,School Totals,200,20,47,.426,12,27,.444,8,20,.400,15,19,.789,2,26,28,14,5,4,12,14,63,False,1793,Purdue
10,School Totals,200,26,64,.406,20,45,.444,6,19,.316,7,10,.700,7,23,30,16,2,3,3,12,65,False,1449,Purdue
10,School Totals,200,19,48,.396,15,31,.484,4,17,.235,11,17,.647,2,29,31,7,2,3,13,18,53,False,3823,Purdue
9,School Totals,200,26,53,.491,19,33,.576,7,20,.350,17,27,.630,8,18,26,13,9,4,9,18,76,False,2098,Purdue
9,School Totals,200,28,48,.583,17,25,.680,11,23,.478,26,31,.839,6,26,32,13,4,4,13,13,93,False,2704,Purdue
12,School Totals,200,32,62,.516,20,37,.541,12,25,.480,8,12,.667,8,21,29,16,9,9,5,12,84,False,3212,Purdue
10,School Totals,200,27,50,.540,14,20,.700,13,30,.433,15,21,.714,6,21,27,19,3,2,9,15,82,False,2427,Purdue
10,School Totals,200,26,50,.520,15,29,.517,11,21,.524,15,22,.682,7,23,30,11,2,4,11,22,78,False,2101,Purdue
10,School Totals,200,25,55,.455,21,38,.553,4,17,.235,12,17,.706,7,28,35,8,2,1,11,21,66,False,1079,Purdue
12,School Totals,200,23,59,.390,14,37,.378,9,22,.409,19,27,.704,9,32,41,10,5,4,9,18,74,False,3824,Purdue
10,School Totals,200,26,52,.500,15,28,.536,11,24,.458,13,18,.722,7,17,24,12,3,3,8,15,76,False,3825,Purdue
10,School Totals,200,26,58,.448,19,40,.475,7,18,.389,6,6,1.000,8,20,28,8,5,2,17,19,65,False,3826,Purdue
13,School Totals,200,32,59,.542,18,29,.621,14,30,.467,12,15,.800,8,28,36,17,4,3,13,17,90,False,3827,Purdue
11,School Totals,198,30,69,.435,23,37,.622,7,32,.219,17,24,.708,18,19,37,17,4,5,11,22,84,False,3828,Purdue
13,School Totals,200,36,66,.545,23,35,.657,13,31,.419,7,10,.700,10,24,34,16,8,5,12,18,92,False,3829,Purdue
13,School Totals,200,28,67,.418,15,33,.455,13,34,.382,10,13,.769,15,26,41,14,3,1,10,11,79,False,3830,Purdue
10,School Totals,200,31,61,.508,17,28,.607,14,33,.424,7,11,.636,11,19,30,18,7,1,13,21,83,False,3831,Purdue
13,School Totals,200,26,58,.448,14,31,.452,12,27,.444,20,23,.870,13,27,40,18,9,9,13,15,84,False,3832,Purdue
11,School Totals,200,22,51,.431,11,21,.524,11,30,.367,17,25,.680,9,20,29,11,5,0,20,19,72,False,3833,Purdue
11,School Totals,200,22,62,.355,13,38,.342,9,24,.375,4,6,.667,12,20,32,12,4,3,9,12,57,False,1093,Purdue
11,School Totals,200,20,50,.400,11,24,.458,9,26,.346,13,16,.813,7,18,25,11,8,7,16,15,62,False,700,Purdue
10,School Totals,200,27,65,.415,18,33,.545,9,32,.281,5,7,.714,7,19,26,6,6,3,6,19,68,False,3834,Purdue
11,School Totals,200,30,70,.429,21,41,.512,9,29,.310,11,18,.611,12,25,37,17,5,2,7,21,80,False,3835,Purdue
13,School Totals,200,34,60,.567,20,31,.645,14,29,.483,13,16,.813,4,29,33,23,9,5,10,16,95,False,3836,Purdue
11,School Totals,200,24,55,.436,17,33,.515,7,22,.318,18,24,.750,9,31,40,9,5,5,10,10,73,False,3837,Purdue
11,School Totals,200,33,62,.532,24,38,.632,9,24,.375,11,12,.917,9,17,26,22,4,3,7,18,86,False,2980,Purdue
11,School Totals,200,20,64,.313,13,33,.394,7,31,.226,12,22,.545,18,15,33,12,7,2,9,17,59,False,1472,Purdue
10,School Totals,225,28,66,.424,17,41,.415,11,25,.440,17,30,.567,15,22,37,12,10,3,8,19,84,False,3838,Purdue
12,School Totals,200,32,64,.500,18,36,.500,14,28,.500,11,16,.688,11,25,36,20,10,5,8,17,89,False,2440,Purdue
11,School Totals,200,27,55,.491,20,33,.606,7,22,.318,9,13,.692,7,26,33,17,10,7,11,20,70,False,318,Purdue
11,School Totals,200,23,48,.479,11,24,.458,12,24,.500,21,25,.840,8,20,28,13,8,3,18,17,79,False,1815,Purdue
10,School Totals,200,24,64,.375,12,36,.333,12,28,.429,13,15,.867,13,24,37,14,7,5,8,15,73,False,1476,Purdue
11,School Totals,225,32,58,.552,16,29,.552,16,29,.552,19,21,.905,5,26,31,16,3,5,9,27,99,False,2123,Purdue
10,School Totals,200,29,61,.475,24,37,.649,5,24,.208,10,17,.588,10,23,33,15,5,6,7,14,73,False,3226,Purdue
10,School Totals,200,27,53,.509,19,33,.576,8,20,.400,19,21,.905,12,27,39,12,8,7,8,17,81,False,3462,Purdue
11,School Totals,200,20,71,.282,13,38,.342,7,33,.212,9,14,.643,13,23,36,5,6,3,3,17,56,False,715,Purdue
11,School Totals,200,22,42,.524,13,26,.500,9,16,.563,23,28,.821,6,25,31,16,10,4,23,20,76,False,2125,Purdue
11,School Totals,200,19,60,.317,13,30,.433,6,30,.200,4,9,.444,10,25,35,7,7,5,10,18,48,False,326,Purdue
11,School Totals,200,23,61,.377,17,35,.486,6,26,.231,23,26,.885,15,27,42,11,2,5,9,19,75,False,3464,Purdue
10,School Totals,200,27,49,.551,22,34,.647,5,15,.333,14,20,.700,10,25,35,16,8,6,14,15,73,False,2725,Purdue
13,School Totals,200,33,59,.559,22,38,.579,11,21,.524,9,16,.563,9,26,35,17,6,2,8,19,86,False,1822,Purdue
11,School Totals,200,24,68,.353,12,37,.324,12,31,.387,9,18,.500,16,23,39,13,9,3,12,24,69,False,3230,Purdue
10,School Totals,200,23,56,.411,16,32,.500,7,24,.292,17,23,.739,10,24,34,15,6,4,6,14,70,False,3658,Purdue
10,School Totals,200,29,66,.439,23,42,.548,6,24,.250,9,10,.900,12,18,30,20,5,2,9,17,73,False,3231,Purdue
10,School Totals,200,20,53,.377,11,23,.478,9,30,.300,12,18,.667,3,28,31,12,4,2,11,12,61,False,3839,Purdue
13,School Totals,200,29,54,.537,13,24,.542,16,30,.533,13,16,.813,11,26,37,19,3,2,11,13,87,False,3840,Purdue
10,School Totals,225,34,63,.540,19,32,.594,15,31,.484,16,33,.485,9,32,41,16,4,5,8,23,99,False,3841,Purdue
10,School Totals,225,27,55,.491,13,23,.565,14,32,.438,7,10,.700,7,23,30,9,1,5,8,17,75,False,3842,Purdue
10,School Totals,200,31,61,.508,25,42,.595,6,19,.316,11,17,.647,10,25,35,16,8,9,10,14,79,False,3843,Purdue
10,School Totals,200,25,61,.410,17,45,.378,8,16,.500,8,12,.667,12,19,31,12,8,2,13,19,66,False,3844,Purdue
10,School Totals,200,20,59,.339,14,35,.400,6,24,.250,9,21,.429,11,22,33,14,4,4,9,22,55,False,3845,Purdue
14,School Totals,200,35,70,.500,24,34,.706,11,36,.306,12,17,.706,20,24,44,24,7,5,8,10,93,False,3846,Purdue
14,School Totals,200,31,56,.554,23,36,.639,8,20,.400,11,14,.786,3,30,33,23,2,7,6,19,81,False,3847,Purdue
10,School Totals,200,18,44,.409,14,28,.500,4,16,.250,19,29,.655,7,21,28,7,10,2,18,23,59,False,3848,Purdue
10,School Totals,225,21,62,.339,16,38,.421,5,24,.208,13,17,.765,14,29,43,10,6,3,24,24,60,False,3849,Purdue
14,School Totals,200,24,53,.453,11,28,.393,13,25,.520,8,12,.667,9,21,30,13,12,1,7,10,69,False,3850,Purdue
10,School Totals,200,23,59,.390,18,37,.486,5,22,.227,7,9,.778,7,28,35,14,5,2,6,10,58,False,3666,Purdue
10,School Totals,200,24,79,.304,18,44,.409,6,35,.171,2,5,.400,18,29,47,12,5,7,9,15,56,False,3477,Purdue
13,School Totals,200,25,51,.490,18,33,.545,7,18,.389,12,18,.667,5,27,32,14,7,0,11,19,69,False,3851,Purdue
9,School Totals,200,19,57,.333,10,37,.270,9,20,.450,14,20,.700,11,17,28,11,6,2,12,26,61,False,3852,Purdue
14,School Totals,200,37,68,.544,23,36,.639,14,32,.438,9,11,.818,13,23,36,24,11,4,15,19,97,False,3853,Purdue
9,School Totals,250,29,68,.426,18,43,.419,11,25,.440,14,23,.609,14,26,40,20,6,3,15,20,83,False,3243,Purdue
14,School Totals,200,15,60,.250,12,43,.279,3,17,.176,4,10,.400,8,20,28,6,3,2,11,10,37,False,2740,Purdue
10,School Totals,250,29,71,.408,23,52,.442,6,19,.316,14,19,.737,12,30,42,7,2,4,15,23,78,False,1133,Purdue
14,School Totals,200,26,57,.456,18,35,.514,8,22,.364,11,18,.611,10,22,32,16,8,7,6,15,71,False,1505,Purdue
10,School Totals,200,20,56,.357,17,39,.436,3,17,.176,7,7,1.000,12,20,32,7,8,2,9,12,50,False,741,Purdue
10,School Totals,200,23,56,.411,20,48,.417,3,8,.375,13,21,.619,10,8,18,8,6,3,5,18,62,False,2743,Purdue
14,School Totals,200,27,60,.450,18,41,.439,9,19,.474,7,9,.778,15,24,39,15,8,5,11,10,70,False,3854,Purdue
10,School Totals,200,25,61,.410,19,39,.487,6,22,.273,7,10,.700,12,19,31,11,7,4,17,25,63,False,2466,Purdue
10,School Totals,200,22,52,.423,13,28,.464,9,24,.375,8,12,.667,7,20,27,11,5,2,10,11,61,False,3670,Purdue
14,School Totals,200,41,65,.631,22,31,.710,19,34,.559,3,8,.375,8,22,30,29,10,2,9,17,104,False,3004,Purdue
10,School Totals,200,25,52,.481,17,36,.472,8,16,.500,16,24,.667,8,19,27,14,6,4,10,14,74,False,358,Purdue
10,School Totals,200,28,61,.459,24,44,.545,4,17,.235,16,25,.640,9,18,27,12,6,2,7,21,76,False,2149,Purdue
10,School Totals,200,19,54,.352,15,34,.441,4,20,.200,10,11,.909,7,18,25,8,9,3,16,21,52,False,1847,Purdue
10,School Totals,200,25,63,.397,18,44,.409,7,19,.368,8,10,.800,15,21,36,13,5,1,9,24,65,False,3855,Purdue
10,School Totals,200,25,63,.397,21,47,.447,4,16,.250,9,12,.750,11,29,40,8,1,4,12,19,63,False,1144,Purdue
10,School Totals,200,21,56,.375,19,39,.487,2,17,.118,13,18,.722,12,27,39,9,8,3,11,18,57,False,363,Purdue
10,School Totals,200,25,67,.373,17,40,.425,8,27,.296,19,22,.864,17,25,42,21,8,4,14,19,77,False,3007,Purdue
10,School Totals,225,22,65,.338,15,36,.417,7,29,.241,17,21,.810,12,27,39,14,5,6,11,17,68,False,2470,Purdue
10,School Totals,200,31,53,.585,22,35,.629,9,18,.500,6,11,.545,4,24,28,20,5,2,15,18,77,False,3856,Purdue
9,School Totals,200,26,58,.448,17,37,.459,9,21,.429,9,11,.818,12,22,34,11,4,3,21,16,70,False,3857,Purdue
12,School Totals,200,33,60,.550,16,28,.571,17,32,.531,10,11,.909,12,26,38,27,4,1,12,14,93,False,3858,Purdue
9,School Totals,200,19,54,.352,13,31,.419,6,23,.261,24,37,.649,9,20,29,13,4,1,9,21,68,False,3859,Purdue
10,School Totals,200,21,60,.350,17,35,.486,4,25,.160,8,10,.800,11,25,36,11,8,2,13,23,54,False,3860,Purdue
10,School Totals,200,30,54,.556,24,38,.632,6,16,.375,14,21,.667,11,25,36,22,3,8,18,13,80,False,3861,Purdue
11,School Totals,200,25,53,.472,19,33,.576,6,20,.300,11,13,.846,7,26,33,16,9,3,15,19,67,False,1856,Purdue
11,School Totals,200,32,65,.492,18,37,.486,14,28,.500,10,15,.667,10,27,37,20,6,2,5,18,88,False,3862,Purdue
11,School Totals,200,23,58,.397,15,33,.455,8,25,.320,1,3,.333,8,24,32,17,6,3,14,16,55,False,3015,Purdue
11,School Totals,200,26,57,.456,16,35,.457,10,22,.455,11,17,.647,9,29,38,16,3,3,9,18,73,False,761,Purdue
11,School Totals,200,29,59,.492,22,33,.667,7,26,.269,11,14,.786,9,22,31,14,2,2,8,15,76,False,2476,Purdue
11,School Totals,200,22,56,.393,15,40,.375,7,16,.438,7,12,.583,5,27,32,11,3,4,14,20,58,False,2756,Purdue
11,School Totals,200,19,56,.339,16,32,.500,3,24,.125,14,19,.737,11,20,31,9,2,3,11,21,55,False,1527,Purdue
11,School Totals,200,25,47,.532,14,30,.467,11,17,.647,20,31,.645,6,30,36,15,3,1,14,24,81,False,381,Purdue
11,School Totals,200,25,62,.403,19,30,.633,6,32,.188,24,33,.727,13,30,43,12,5,7,11,16,80,False,2160,Purdue
11,School Totals,200,26,54,.481,21,34,.618,5,20,.250,10,17,.588,7,26,33,4,5,1,10,18,67,False,1865,Purdue
10,School Totals,200,20,65,.308,18,53,.340,2,12,.167,11,15,.733,18,21,39,11,6,6,14,16,53,False,1159,Purdue
10,School Totals,200,27,57,.474,19,42,.452,8,15,.533,19,24,.792,15,25,40,11,8,2,10,18,81,False,3258,Purdue
10,School Totals,200,22,50,.440,18,33,.545,4,17,.235,12,15,.800,10,22,32,9,3,1,14,15,60,False,770,Purdue
10,School Totals,200,22,54,.407,14,31,.452,8,23,.348,23,24,.958,8,24,32,14,10,4,9,15,75,False,3677,Purdue
11,School Totals,200,27,62,.435,25,45,.556,2,17,.118,12,16,.750,12,23,35,15,6,5,9,14,68,False,3260,Purdue
11,School Totals,200,28,57,.491,25,45,.556,3,12,.250,16,24,.667,8,19,27,12,6,6,6,20,75,False,1534,Purdue
11,School Totals,200,30,64,.469,20,32,.625,10,32,.313,5,10,.500,10,34,44,16,8,4,13,15,75,False,3493,Purdue
15,School Totals,200,27,52,.519,20,33,.606,7,19,.368,12,17,.706,5,32,37,13,8,6,13,18,73,False,2169,Purdue
10,School Totals,200,24,50,.480,19,36,.528,5,14,.357,20,26,.769,10,24,34,18,3,3,10,19,73,False,3863,Purdue
10,School Totals,200,23,48,.479,17,27,.630,6,21,.286,15,19,.789,8,26,34,13,6,2,15,18,67,False,393,Purdue
10,School Totals,225,27,62,.435,18,36,.500,9,26,.346,15,27,.556,13,18,31,16,4,7,9,15,78,False,1873,Purdue
10,School Totals,225,25,69,.362,16,39,.410,9,30,.300,10,14,.714,18,19,37,13,2,6,11,18,69,False,3864,Purdue
12,School Totals,200,28,49,.571,22,31,.710,6,18,.333,13,17,.765,7,25,32,13,7,11,13,16,75,False,3865,Wisconsin
11,School Totals,200,22,53,.415,19,39,.487,3,14,.214,11,13,.846,12,22,34,13,9,8,15,12,58,False,3866,Wisconsin
11,School Totals,200,22,61,.361,18,43,.419,4,18,.222,17,29,.586,10,26,36,9,5,3,7,24,65,False,3867,Wisconsin
10,School Totals,200,23,59,.390,18,35,.514,5,24,.208,10,14,.714,8,19,27,12,2,2,9,19,61,False,3868,Wisconsin
11,School Totals,200,26,53,.491,16,31,.516,10,22,.455,16,20,.800,11,22,33,14,5,2,15,18,78,False,400,Wisconsin
10,School Totals,200,26,59,.441,18,39,.462,8,20,.400,13,19,.684,10,22,32,17,4,6,4,14,73,False,3869,Wisconsin
15,School Totals,200,27,45,.600,21,33,.636,6,12,.500,19,28,.679,6,30,36,18,3,6,10,13,79,False,3870,Wisconsin
9,School Totals,225,24,53,.453,17,34,.500,7,19,.368,29,40,.725,14,24,38,14,7,3,18,22,84,False,3871,Wisconsin
9,School Totals,200,23,52,.442,20,42,.476,3,10,.300,23,33,.697,9,19,28,8,7,4,7,18,72,False,3872,Wisconsin
16,School Totals,200,31,51,.608,18,27,.667,13,24,.542,15,19,.789,5,24,29,22,12,0,9,12,90,False,3873,Wisconsin
9,School Totals,200,23,51,.451,19,35,.543,4,16,.250,18,20,.900,9,22,31,10,1,4,6,13,68,False,3874,Wisconsin
15,School Totals,200,29,56,.518,18,33,.545,11,23,.478,10,14,.714,13,26,39,16,5,2,9,11,79,False,3875,Wisconsin
14,School Totals,200,21,45,.467,11,24,.458,10,21,.476,13,16,.813,6,25,31,15,6,3,10,16,65,False,1550,Wisconsin
11,School Totals,200,23,49,.469,15,29,.517,8,20,.400,9,12,.750,4,28,32,13,5,1,7,17,63,False,1889,Wisconsin
11,School Totals,200,17,51,.333,12,28,.429,5,23,.217,8,12,.667,5,18,23,10,8,3,9,21,47,False,1186,Wisconsin
10,School Totals,200,23,56,.411,18,37,.486,5,19,.263,22,27,.815,7,28,35,9,4,4,7,20,73,False,3691,Wisconsin
9,School Totals,200,20,52,.385,13,26,.500,7,26,.269,13,17,.765,15,19,34,14,2,3,4,15,60,False,3507,Wisconsin
10,School Totals,200,19,47,.404,10,21,.476,9,26,.346,4,5,.800,7,19,26,7,3,2,13,17,51,False,1553,Wisconsin
9,School Totals,200,18,53,.340,14,29,.483,4,24,.167,14,17,.824,9,23,32,9,6,3,5,12,54,False,799,Wisconsin
9,School Totals,225,26,60,.433,16,27,.593,10,33,.303,17,19,.895,5,18,23,15,12,9,5,12,79,False,1892,Wisconsin
10,School Totals,200,20,50,.400,11,27,.407,9,23,.391,8,14,.571,5,15,20,13,7,1,9,16,57,False,3692,Wisconsin
10,School Totals,200,28,55,.509,19,29,.655,9,26,.346,2,4,.500,7,18,25,17,6,2,5,14,67,False,1193,Wisconsin
13,School Totals,200,22,41,.537,11,20,.550,11,21,.524,7,12,.583,8,20,28,13,2,1,7,14,62,False,804,Wisconsin
9,School Totals,200,20,56,.357,9,27,.333,11,29,.379,5,9,.556,9,16,25,9,6,2,6,15,56,False,2506,Wisconsin
13,School Totals,200,32,63,.508,22,38,.579,10,25,.400,9,11,.818,14,18,32,18,8,3,10,17,83,False,23,Wisconsin
10,School Totals,200,18,59,.305,7,29,.241,11,30,.367,5,7,.714,11,10,21,11,5,2,5,24,52,False,3041,Wisconsin
10,School Totals,200,20,39,.513,13,19,.684,7,20,.350,23,29,.793,6,16,22,12,3,6,9,19,70,False,3509,Wisconsin
12,School Totals,200,29,53,.547,21,42,.500,8,11,.727,12,15,.800,7,23,30,11,7,9,13,18,78,False,26,Wisconsin
16,School Totals,200,28,51,.549,22,39,.564,6,12,.500,5,6,.833,6,24,30,16,5,6,6,10,67,False,2786,Wisconsin
10,School Totals,200,26,62,.419,19,44,.432,7,18,.389,13,20,.650,17,23,40,8,2,0,3,19,72,False,2509,Wisconsin
10,School Totals,200,18,63,.286,8,34,.235,10,29,.345,8,14,.571,10,20,30,10,11,1,5,18,54,False,2510,Wisconsin
9,School Totals,200,20,54,.370,19,45,.422,1,9,.111,12,19,.632,9,20,29,3,7,0,4,14,53,False,3876,Wisconsin
11,School Totals,200,24,49,.490,16,24,.667,8,25,.320,13,17,.765,7,13,20,13,6,1,10,16,69,False,3877,Wisconsin
13,School Totals,200,34,68,.500,21,37,.568,13,31,.419,18,22,.818,23,22,45,22,9,5,12,11,99,False,3878,Wisconsin
14,School Totals,200,31,50,.620,26,39,.667,5,11,.455,18,21,.857,9,21,30,20,5,2,13,18,85,False,3879,Wisconsin
12,School Totals,200,19,52,.365,13,32,.406,6,20,.300,21,26,.808,12,23,35,9,1,3,15,19,65,False,3880,Wisconsin
13,School Totals,200,21,58,.362,16,37,.432,5,21,.238,3,5,.600,11,25,36,15,6,3,8,12,50,False,3881,Wisconsin
9,School Totals,200,26,57,.456,23,41,.561,3,16,.188,10,13,.769,10,20,30,9,2,5,3,9,65,False,3882,Wisconsin
11,School Totals,200,20,57,.351,13,34,.382,7,23,.304,4,4,1.000,6,22,28,14,5,5,4,22,51,False,3883,Wisconsin
15,School Totals,200,28,56,.500,17,36,.472,11,20,.550,20,26,.769,13,27,40,17,5,4,6,11,87,False,3884,Wisconsin
12,School Totals,200,29,64,.453,17,33,.515,12,31,.387,6,9,.667,13,21,34,20,7,5,9,7,76,False,3885,Wisconsin
15,School Totals,200,23,50,.460,18,35,.514,5,15,.333,10,12,.833,11,25,36,11,3,5,13,17,61,False,3886,Wisconsin
13,School Totals,200,26,57,.456,20,38,.526,6,19,.316,11,14,.786,15,17,32,14,3,3,10,19,69,False,3887,Wisconsin
12,School Totals,200,21,43,.488,11,26,.423,10,17,.588,18,22,.818,8,21,29,14,1,8,11,11,70,False,3888,Wisconsin
17,School Totals,200,27,56,.482,10,18,.556,17,38,.447,9,13,.692,10,21,31,17,3,3,5,12,80,False,3889,Wisconsin
10,School Totals,200,21,51,.412,12,27,.444,9,24,.375,17,18,.944,4,20,24,14,2,9,2,16,68,False,3057,Wisconsin
12,School Totals,200,21,60,.350,11,25,.440,10,35,.286,9,12,.750,11,13,24,13,3,2,3,20,61,False,2527,Wisconsin
11,School Totals,200,21,44,.477,12,25,.480,9,19,.474,15,18,.833,5,21,26,12,4,1,8,11,66,False,828,Wisconsin
11,School Totals,224,21,55,.382,13,35,.371,8,20,.400,11,12,.917,8,20,28,12,6,4,10,20,61,False,1220,Wisconsin
11,School Totals,200,18,46,.391,12,26,.462,6,20,.300,34,41,.829,11,21,32,7,1,4,7,24,76,False,2529,Wisconsin
11,School Totals,200,24,49,.490,19,33,.576,5,16,.313,16,17,.941,5,19,24,12,3,5,4,12,69,False,49,Wisconsin
15,School Totals,200,31,56,.554,19,30,.633,12,26,.462,4,5,.800,9,22,31,22,4,1,3,15,78,False,3525,Wisconsin
12,School Totals,200,22,52,.423,16,32,.500,6,20,.300,2,3,.667,6,17,23,11,2,1,7,20,52,False,1914,Wisconsin
9,School Totals,200,23,55,.418,16,37,.432,7,18,.389,13,16,.813,11,20,31,10,8,1,7,11,66,False,3709,Wisconsin
14,School Totals,200,23,39,.590,12,22,.545,11,17,.647,25,26,.962,3,17,20,10,2,0,8,16,82,False,1225,Wisconsin
10,School Totals,225,24,68,.353,16,39,.410,8,29,.276,6,7,.857,16,23,39,19,3,4,7,11,62,False,2803,Wisconsin
10,School Totals,200,25,49,.510,13,25,.520,12,24,.500,9,13,.692,5,18,23,11,2,2,8,17,71,False,1590,Wisconsin
11,School Totals,200,24,59,.407,21,40,.525,3,19,.158,11,13,.846,11,24,35,10,1,1,6,16,62,False,3710,Wisconsin
10,School Totals,200,25,46,.543,17,31,.548,8,15,.533,18,21,.857,8,16,24,17,2,2,7,12,76,False,1918,Wisconsin
11,School Totals,200,21,58,.362,13,29,.448,8,29,.276,3,3,1.000,9,22,31,11,4,2,5,13,53,False,840,Wisconsin
14,School Totals,200,27,47,.574,19,28,.679,8,19,.421,16,20,.800,4,21,25,12,3,0,6,14,78,False,3526,Wisconsin
11,School Totals,200,24,49,.490,15,33,.455,9,16,.563,20,22,.909,9,20,29,7,2,1,3,22,77,False,60,Wisconsin
11,School Totals,200,25,60,.417,16,36,.444,9,24,.375,6,9,.667,12,13,25,10,1,5,6,17,65,False,1594,Wisconsin
11,School Totals,200,15,51,.294,13,30,.433,2,21,.095,1,3,.333,9,16,25,6,4,2,5,12,33,False,1921,Wisconsin
11,School Totals,200,20,40,.500,8,18,.444,12,22,.545,20,25,.800,5,24,29,13,3,2,12,17,72,False,3890,Wisconsin
10,School Totals,200,21,50,.420,12,30,.400,9,20,.450,19,23,.826,8,19,27,12,4,2,5,18,70,False,3891,Wisconsin
15,School Totals,200,17,56,.304,10,27,.370,7,29,.241,13,19,.684,10,18,28,9,7,3,11,20,54,False,3892,Wisconsin
14,School Totals,200,30,51,.588,15,26,.577,15,25,.600,10,13,.769,9,31,40,23,7,3,10,12,85,False,3893,Wisconsin
13,School Totals,200,27,61,.443,17,38,.447,10,23,.435,4,14,.286,13,27,40,8,11,2,5,13,68,False,3894,Wisconsin
15,School Totals,200,28,56,.500,19,33,.576,9,23,.391,4,4,1.000,11,28,39,19,3,4,8,9,69,False,3895,Wisconsin
15,School Totals,200,30,58,.517,17,31,.548,13,27,.481,4,8,.500,7,34,41,18,3,7,7,9,77,False,3896,Wisconsin
12,School Totals,200,25,59,.424,17,37,.459,8,22,.364,8,12,.667,10,28,38,16,10,4,10,13,66,False,3897,Wisconsin
14,School Totals,200,27,53,.509,14,29,.483,13,24,.542,6,7,.857,8,19,27,19,2,5,11,12,73,False,3898,Wisconsin
9,School Totals,200,23,64,.359,15,36,.417,8,28,.286,3,6,.500,9,17,26,6,9,4,4,21,57,False,3899,Wisconsin
9,School Totals,200,16,50,.320,11,31,.355,5,19,.263,17,21,.810,8,20,28,8,5,3,12,18,54,False,3900,Wisconsin
15,School Totals,200,27,59,.458,24,42,.571,3,17,.176,13,19,.684,11,22,33,16,8,7,6,11,70,False,3901,Wisconsin
10,School Totals,200,20,54,.370,10,28,.357,10,26,.385,12,18,.667,10,24,34,12,8,0,10,11,62,False,3902,Wisconsin
9,School Totals,200,19,46,.413,13,32,.406,6,14,.429,16,20,.800,4,25,29,9,1,3,7,12,60,False,3903,Wisconsin
14,School Totals,200,25,44,.568,22,36,.611,3,8,.375,13,19,.684,7,20,27,7,9,6,7,10,66,False,3904,Wisconsin
14,School Totals,200,22,44,.500,18,34,.529,4,10,.400,31,44,.705,9,26,35,12,7,3,13,15,79,False,3905,Wisconsin
12,School Totals,200,24,47,.511,13,26,.500,11,21,.524,5,5,1.000,6,24,30,13,6,2,7,11,64,False,3340,Wisconsin
9,School Totals,200,24,69,.348,21,41,.512,3,28,.107,14,17,.824,15,20,35,9,3,5,8,18,65,False,2821,Wisconsin
8,School Totals,225,18,54,.333,13,32,.406,5,22,.227,19,27,.704,9,18,27,5,3,4,8,19,60,False,1250,Wisconsin
10,School Totals,200,16,51,.314,9,31,.290,7,20,.350,2,5,.400,11,16,27,6,6,2,12,16,41,False,861,Wisconsin
9,School Totals,200,19,40,.475,10,20,.500,9,20,.450,20,24,.833,3,28,31,13,1,4,11,16,67,False,3726,Wisconsin
9,School Totals,200,15,48,.313,13,30,.433,2,18,.111,18,24,.750,14,25,39,5,5,3,12,7,50,False,3341,Wisconsin
14,School Totals,200,27,54,.500,15,31,.484,12,23,.522,11,14,.786,9,22,31,16,6,1,9,17,77,False,3542,Wisconsin
9,School Totals,200,24,54,.444,15,32,.469,9,22,.409,10,18,.556,7,26,33,12,4,1,10,14,67,False,2553,Wisconsin
9,School Totals,200,19,48,.396,15,31,.484,4,17,.235,15,19,.789,7,17,24,8,3,8,4,10,57,False,83,Wisconsin
9,School Totals,200,17,48,.354,12,29,.414,5,19,.263,13,19,.684,8,20,28,7,6,6,5,13,52,False,1941,Wisconsin
9,School Totals,200,22,55,.400,17,28,.607,5,27,.185,3,3,1.000,7,18,25,10,7,4,9,15,52,False,1619,Wisconsin
9,School Totals,225,19,53,.358,10,30,.333,9,23,.391,21,25,.840,10,20,30,13,7,6,9,14,68,False,3079,Wisconsin
9,School Totals,200,18,53,.340,13,29,.448,5,24,.208,14,14,1.000,12,21,33,10,5,1,10,23,55,False,1258,Wisconsin
10,School Totals,200,20,47,.426,9,25,.360,11,22,.500,14,17,.824,10,27,37,14,1,2,12,11,65,False,1945,Wisconsin
10,School Totals,200,29,57,.509,23,41,.561,6,16,.375,2,3,.667,7,21,28,11,6,6,12,16,66,False,2827,Wisconsin
9,School Totals,200,23,55,.418,15,34,.441,8,21,.381,9,11,.818,8,22,30,13,1,2,7,18,63,False,1623,Wisconsin
9,School Totals,200,12,39,.308,6,17,.353,6,22,.273,22,29,.759,5,20,25,10,2,3,8,19,52,False,3081,Wisconsin
12,School Totals,200,21,47,.447,14,28,.500,7,19,.368,21,27,.778,6,27,33,12,6,1,6,14,70,False,2559,Wisconsin
9,School Totals,200,27,56,.482,14,30,.467,13,26,.500,12,16,.750,10,16,26,16,4,2,5,16,79,False,95,Wisconsin
9,School Totals,200,17,49,.347,10,29,.345,7,20,.350,11,14,.786,6,15,21,9,7,1,10,14,52,False,1264,Wisconsin
14,School Totals,200,23,48,.479,13,29,.448,10,19,.526,17,19,.895,8,24,32,15,3,8,10,15,73,False,3906,Wisconsin
9,School Totals,200,23,55,.418,13,22,.591,10,33,.303,4,8,.500,8,19,27,13,4,1,8,16,60,False,3907,Wisconsin
10,School Totals,200,21,49,.429,7,22,.318,14,27,.519,7,12,.583,8,15,23,15,2,2,6,12,63,False,3908,Wisconsin
15,School Totals,200,32,61,.525,24,40,.600,8,21,.381,15,23,.652,18,29,47,14,4,7,8,6,87,False,3909,Wisconsin
11,School Totals,200,21,59,.356,14,35,.400,7,24,.292,7,14,.500,12,9,21,12,11,1,10,18,56,False,3910,Wisconsin
14,School Totals,200,27,67,.403,21,45,.467,6,22,.273,13,14,.929,16,34,50,18,10,9,15,11,73,False,3911,Wisconsin
15,School Totals,200,33,63,.524,17,26,.654,16,37,.432,6,9,.667,12,26,38,24,10,3,6,10,88,False,3912,Wisconsin
10,School Totals,200,27,66,.409,19,39,.487,8,27,.296,12,16,.750,13,20,33,8,5,4,8,20,74,False,3913,Wisconsin
11,School Totals,200,22,49,.449,14,30,.467,8,19,.421,25,38,.658,12,25,37,13,3,5,11,18,77,False,3914,Wisconsin
9,School Totals,200,21,55,.382,13,33,.394,8,22,.364,4,5,.800,5,13,18,12,6,3,5,15,54,False,3915,Wisconsin
15,School Totals,200,30,58,.517,23,37,.622,7,21,.333,14,25,.560,13,21,34,18,16,5,13,19,81,False,3916,Wisconsin
15,School Totals,200,34,70,.486,26,43,.605,8,27,.296,10,16,.625,18,28,46,16,9,4,9,11,86,False,3917,Wisconsin
10,School Totals,200,17,52,.327,10,27,.370,7,25,.280,9,23,.391,12,21,33,13,7,3,13,17,50,False,3918,Wisconsin
10,School Totals,200,24,51,.471,19,38,.500,5,13,.385,12,20,.600,5,25,30,15,5,8,6,11,65,False,3919,Wisconsin
10,School Totals,200,28,59,.475,21,45,.467,7,14,.500,11,13,.846,10,24,34,17,7,2,8,12,74,False,3920,Wisconsin
15,School Totals,200,31,59,.525,19,37,.514,12,22,.545,13,17,.765,13,30,43,21,6,6,6,13,87,False,3921,Wisconsin
9,School Totals,200,22,57,.386,19,40,.475,3,17,.176,13,26,.500,9,19,28,10,7,6,4,7,60,False,1960,Wisconsin
10,School Totals,200,20,53,.377,16,36,.444,4,17,.235,3,13,.231,7,27,34,8,2,6,6,9,47,False,3358,Wisconsin
15,School Totals,200,28,57,.491,18,34,.529,10,23,.435,8,13,.615,18,23,41,11,4,2,13,20,74,False,2577,Wisconsin
9,School Totals,200,23,51,.451,16,29,.552,7,22,.318,11,14,.786,6,20,26,12,4,3,8,17,64,False,115,Wisconsin
10,School Totals,200,25,58,.431,17,35,.486,8,23,.348,8,12,.667,10,22,32,12,0,0,12,23,66,False,2846,Wisconsin
9,School Totals,200,16,54,.296,8,27,.296,8,27,.296,7,18,.389,14,18,32,8,5,2,9,12,47,False,1288,Wisconsin
10,School Totals,200,17,46,.370,10,24,.417,7,22,.318,4,8,.500,8,24,32,8,4,1,10,16,45,False,3104,Wisconsin
9,School Totals,200,19,52,.365,8,24,.333,11,28,.393,0,0,,6,17,23,13,1,3,7,16,49,False,1648,Wisconsin
10,School Totals,200,21,49,.429,17,35,.486,4,14,.286,28,42,.667,9,29,38,9,3,2,8,16,74,False,2580,Wisconsin
9,School Totals,250,24,71,.338,17,46,.370,7,25,.280,19,26,.731,11,34,45,11,6,8,12,20,74,False,2849,Wisconsin
9,School Totals,225,25,57,.439,15,33,.455,10,24,.417,5,10,.500,7,32,39,14,4,5,14,8,65,False,901,Wisconsin
9,School Totals,225,18,59,.305,11,31,.355,7,28,.250,10,17,.588,12,23,35,12,5,3,10,16,53,False,3106,Wisconsin
15,School Totals,200,29,55,.527,22,36,.611,7,19,.368,6,10,.600,9,26,35,16,5,4,9,9,71,False,1651,Wisconsin
15,School Totals,200,23,50,.460,18,33,.545,5,17,.294,18,26,.692,14,29,43,16,5,3,8,10,69,False,3560,Wisconsin
15,School Totals,200,27,53,.509,15,28,.536,12,25,.480,11,16,.688,5,32,37,19,4,8,8,10,77,False,3361,Wisconsin
9,School Totals,200,22,55,.400,16,27,.593,6,28,.214,6,8,.750,6,20,26,12,8,6,11,17,56,False,3742,Wisconsin
12,School Totals,200,15,51,.294,11,28,.393,4,23,.174,9,15,.600,12,27,39,11,4,3,16,14,43,False,1294,Wisconsin
10,School Totals,200,22,51,.431,15,30,.500,7,21,.333,12,15,.800,5,22,27,13,1,3,8,15,63,False,1971,Wisconsin
9,School Totals,200,22,57,.386,14,35,.400,8,22,.364,16,21,.762,7,26,33,13,9,5,9,14,68,False,909,Wisconsin
9,School Totals,200,25,49,.510,18,31,.581,7,18,.389,11,18,.611,9,20,29,15,9,10,15,13,68,False,131,Wisconsin
9,School Totals,200,18,47,.383,15,29,.517,3,18,.167,4,8,.500,5,21,26,11,4,3,8,12,43,False,1656,Wisconsin
9,School Totals,200,15,59,.254,8,29,.276,7,30,.233,9,13,.692,13,25,38,10,7,7,11,16,46,False,3922,Wisconsin
10,School Totals,200,25,54,.463,14,31,.452,11,23,.478,25,30,.833,11,19,30,13,3,2,9,23,86,False,3923,Wisconsin
9,School Totals,200,21,48,.438,12,28,.429,9,20,.450,8,14,.571,7,22,29,11,3,2,13,17,59,False,3924,Wisconsin
9,School Totals,200,26,59,.441,21,41,.512,5,18,.278,12,17,.706,3,28,31,9,6,7,10,13,69,False,3925,Wisconsin
13,School Totals,200,35,59,.593,23,39,.590,12,20,.600,21,29,.724,8,22,30,19,7,6,9,17,103,False,3926,Wisconsin
13,School Totals,200,28,51,.549,16,31,.516,12,20,.600,20,26,.769,5,28,33,14,4,2,10,14,88,False,3927,Wisconsin
9,School Totals,200,27,57,.474,20,34,.588,7,23,.304,15,18,.833,11,17,28,14,7,1,8,10,76,False,3928,Wisconsin
9,School Totals,200,21,45,.467,17,33,.515,4,12,.333,17,30,.567,5,31,36,6,4,8,9,17,63,False,3929,Wisconsin
9,School Totals,200,22,54,.407,11,27,.407,11,27,.407,15,17,.882,9,28,37,14,3,3,7,12,70,False,3930,Wisconsin
9,School Totals,200,15,52,.288,10,29,.345,5,23,.217,13,20,.650,11,27,38,7,5,4,7,14,48,False,3931,Wisconsin
11,School Totals,200,22,55,.400,15,29,.517,7,26,.269,19,23,.826,13,18,31,14,2,4,5,16,70,False,3932,Wisconsin
13,School Totals,200,31,61,.508,21,35,.600,10,26,.385,6,9,.667,7,26,33,16,12,3,8,16,78,False,3933,Wisconsin
12,School Totals,200,26,43,.605,17,28,.607,9,15,.600,25,33,.758,7,25,32,17,4,1,11,10,86,False,3934,Wisconsin
13,School Totals,200,25,58,.431,16,31,.516,9,27,.333,21,28,.750,14,25,39,14,6,3,2,8,80,False,3935,Wisconsin
13,School Totals,200,32,58,.552,27,42,.643,5,16,.313,7,10,.700,8,26,34,16,6,4,4,15,76,False,3575,Wisconsin
10,School Totals,200,20,53,.377,10,31,.323,10,22,.455,25,35,.714,10,19,29,11,2,6,11,22,75,False,2874,Wisconsin
13,School Totals,200,32,57,.561,24,38,.632,8,19,.421,23,33,.697,5,29,34,11,5,3,4,14,95,False,2602,Wisconsin
9,School Totals,200,32,60,.533,25,37,.676,7,23,.304,1,4,.250,6,20,26,13,4,4,10,16,72,False,151,Wisconsin
9,School Totals,200,26,60,.433,19,42,.452,7,18,.389,11,14,.786,7,22,29,11,4,2,9,15,70,False,932,Wisconsin
11,School Totals,200,22,50,.440,17,30,.567,5,20,.250,19,23,.826,9,11,20,8,4,3,6,14,68,False,3125,Wisconsin
10,School Totals,200,19,46,.413,12,26,.462,7,20,.350,27,33,.818,7,26,33,11,6,6,9,16,72,False,3758,Wisconsin
9,School Totals,200,15,57,.263,10,33,.303,5,24,.208,21,27,.778,8,24,32,10,10,5,9,17,56,False,3577,Wisconsin
9,School Totals,200,18,45,.400,15,28,.536,3,17,.176,19,29,.655,7,22,29,7,3,1,7,14,58,False,1680,Wisconsin
9,School Totals,200,22,46,.478,12,23,.522,10,23,.435,21,26,.808,8,21,29,13,4,2,11,18,75,False,2606,Wisconsin
9,School Totals,200,19,42,.452,10,19,.526,9,23,.391,13,20,.650,3,25,28,10,5,3,14,13,60,False,1321,Wisconsin
9,School Totals,200,21,43,.488,15,28,.536,6,15,.400,30,36,.833,3,23,26,8,7,1,7,15,78,False,3129,Wisconsin
9,School Totals,200,26,58,.448,19,41,.463,7,17,.412,16,21,.762,10,24,34,10,5,2,2,16,75,False,939,Wisconsin
9,School Totals,200,30,63,.476,22,39,.564,8,24,.333,11,13,.846,12,20,32,15,4,2,7,13,79,False,2878,Wisconsin
13,School Totals,200,20,48,.417,13,27,.481,7,21,.333,22,24,.917,4,22,26,8,6,6,3,7,69,False,161,Wisconsin
9,School Totals,200,22,50,.440,14,26,.538,8,24,.333,19,24,.792,6,18,24,15,7,2,7,14,71,False,1993,Wisconsin
11,School Totals,200,23,52,.442,16,34,.471,7,18,.389,23,31,.742,7,23,30,12,7,3,6,15,76,False,3759,Wisconsin
10,School Totals,200,24,56,.429,15,36,.417,9,20,.450,11,21,.524,10,23,33,14,1,6,11,18,68,False,3379,Wisconsin
13,School Totals,200,30,55,.545,20,31,.645,10,24,.417,13,21,.619,4,31,35,16,7,7,7,16,83,False,3131,Wisconsin
9,School Totals,200,22,50,.440,15,32,.469,7,18,.389,24,31,.774,5,18,23,13,2,2,6,18,75,False,1329,Wisconsin
13,School Totals,200,26,52,.500,16,29,.552,10,23,.435,13,14,.929,5,24,29,13,9,1,7,15,75,False,3936,Wisconsin
9,School Totals,200,29,60,.483,18,32,.563,11,28,.393,16,25,.640,12,20,32,15,1,1,8,16,85,False,3937,Wisconsin
13,School Totals,200,26,51,.510,20,35,.571,6,16,.375,11,20,.550,8,27,35,18,1,6,10,16,69,False,3938,Wisconsin
9,School Totals,225,24,61,.393,18,44,.409,6,17,.353,10,12,.833,11,23,34,11,3,0,8,14,64,False,3939,Wisconsin
10,School Totals,200,23,50,.460,15,30,.500,8,20,.400,19,20,.950,6,21,27,11,4,3,8,18,73,False,3940,Wisconsin
13,School Totals,200,23,47,.489,19,30,.633,4,17,.235,12,20,.600,5,35,40,13,3,5,9,9,62,False,3941,Wisconsin
13,School Totals,200,32,60,.533,24,42,.571,8,18,.444,17,23,.739,10,35,45,20,5,2,9,13,89,False,3942,Wisconsin
11,School Totals,200,27,52,.519,21,35,.600,6,17,.353,24,37,.649,12,33,45,13,4,8,7,13,84,False,3943,Wisconsin
14,School Totals,200,31,56,.554,21,29,.724,10,27,.370,6,6,1.000,8,19,27,16,5,4,5,11,78,False,3944,Wisconsin
13,School Totals,200,27,52,.519,22,34,.647,5,18,.278,13,22,.591,8,21,29,14,8,5,10,15,72,False,3945,Wisconsin
10,School Totals,200,21,43,.488,15,27,.556,6,16,.375,20,27,.741,10,15,25,9,6,3,13,17,68,False,3946,Wisconsin
10,School Totals,200,27,62,.435,18,34,.529,9,28,.321,6,8,.750,6,25,31,19,12,3,10,18,69,False,3947,Wisconsin
9,School Totals,200,22,54,.407,13,33,.394,9,21,.429,17,21,.810,8,17,25,11,2,2,8,17,70,False,3948,Wisconsin
8,School Totals,200,17,52,.327,9,22,.409,8,30,.267,7,9,.778,12,23,35,14,7,6,11,15,49,False,3949,Wisconsin
14,School Totals,200,39,64,.609,31,48,.646,8,16,.500,7,9,.778,4,29,33,10,10,2,4,13,93,False,3950,Wisconsin
13,School Totals,200,28,54,.519,24,40,.600,4,14,.286,26,35,.743,12,23,35,14,10,5,10,13,86,False,3951,Wisconsin
12,School Totals,200,24,55,.436,21,44,.477,3,11,.273,17,18,.944,7,30,37,8,2,2,6,12,68,False,3952,Wisconsin
9,School Totals,200,25,59,.424,19,39,.487,6,20,.300,12,13,.923,11,24,35,11,3,9,8,13,68,False,3953,Wisconsin
14,School Totals,200,30,47,.638,24,34,.706,6,13,.462,23,28,.821,5,20,25,9,4,3,9,13,89,False,2012,Wisconsin
13,School Totals,200,30,57,.526,18,32,.563,12,25,.480,9,15,.600,6,26,32,23,2,3,7,9,81,False,3592,Wisconsin
9,School Totals,200,17,39,.436,14,25,.560,3,14,.214,25,31,.806,4,17,21,6,6,4,8,12,62,False,3773,Wisconsin
9,School Totals,200,24,56,.429,19,35,.543,5,21,.238,9,16,.563,11,17,28,11,1,2,5,14,62,False,2348,Wisconsin
13,School Totals,200,21,43,.488,10,22,.455,11,21,.524,17,23,.739,5,21,26,9,1,4,6,14,70,False,3393,Wisconsin
13,School Totals,200,29,59,.492,20,37,.541,9,22,.409,15,19,.789,13,19,32,16,6,2,0,9,82,False,2898,Wisconsin
9,School Totals,225,24,51,.471,17,30,.567,7,21,.333,14,19,.737,8,19,27,12,4,1,8,12,69,False,970,Wisconsin
9,School Totals,200,23,52,.442,16,33,.485,7,19,.368,21,26,.808,10,19,29,9,5,1,6,15,74,False,2900,Wisconsin
9,School Totals,200,29,48,.604,23,37,.622,6,11,.545,28,31,.903,3,18,21,15,3,6,6,15,92,False,189,Wisconsin
9,School Totals,200,21,54,.389,12,26,.462,9,28,.321,14,17,.824,11,26,37,14,1,1,5,12,65,False,3594,Wisconsin
9,School Totals,200,18,46,.391,13,28,.464,5,18,.278,24,31,.774,8,30,38,9,3,4,7,12,65,False,3395,Wisconsin
11,School Totals,200,27,53,.509,22,39,.564,5,14,.357,9,15,.600,13,16,29,11,6,0,4,11,68,False,2630,Wisconsin
9,School Totals,200,20,51,.392,15,29,.517,5,22,.227,10,15,.667,8,26,34,12,3,2,8,9,55,False,2019,Wisconsin
9,School Totals,200,23,49,.469,17,32,.531,6,17,.353,11,14,.786,5,20,25,11,2,9,8,7,63,False,3155,Wisconsin
9,School Totals,200,20,52,.385,14,30,.467,6,22,.273,7,12,.583,10,21,31,6,3,4,8,12,53,False,587,Wisconsin
9,School Totals,200,26,50,.520,22,36,.611,4,14,.286,12,15,.800,7,23,30,10,3,3,8,9,68,False,1357,Wisconsin
9,School Totals,200,28,56,.500,18,36,.500,10,20,.500,10,12,.833,8,21,29,18,3,5,9,11,76,False,3156,Wisconsin
12,School Totals,200,31,62,.500,24,41,.585,7,21,.333,3,3,1.000,13,26,39,10,5,2,9,11,72,False,1714,Wisconsin
8,School Totals,200,25,51,.490,18,32,.563,7,19,.368,14,16,.875,12,21,33,13,4,1,7,5,71,False,980,Wisconsin
13,School Totals,200,26,55,.473,18,33,.545,8,22,.364,11,12,.917,10,20,30,18,5,5,3,7,71,False,3774,Wisconsin
8,School Totals,225,25,52,.481,12,26,.462,13,26,.500,17,20,.850,3,18,21,18,7,1,6,11,80,False,1360,Wisconsin
12,School Totals,200,33,61,.541,22,34,.647,11,27,.407,9,12,.750,12,22,34,14,5,1,9,11,86,False,3954,Wisconsin
8,School Totals,200,22,51,.431,15,28,.536,7,23,.304,21,29,.724,7,20,27,11,3,3,6,13,72,False,3955,Wisconsin
9,School Totals,200,26,56,.464,19,35,.543,7,21,.333,20,23,.870,11,22,33,13,3,0,5,18,79,False,3956,Wisconsin
10,School Totals,200,25,45,.556,13,27,.481,12,18,.667,23,31,.742,2,16,18,11,5,1,8,21,85,False,3957,Wisconsin
10,School Totals,200,23,48,.479,16,31,.516,7,17,.412,18,22,.818,9,21,30,10,1,2,10,14,71,False,3958,Wisconsin
8,School Totals,200,25,61,.410,18,40,.450,7,21,.333,6,10,.600,9,24,33,13,3,1,5,15,63,False,3959,Wisconsin
9,School Totals,200,22,62,.355,15,41,.366,7,21,.333,16,25,.640,19,18,37,8,6,6,3,15,67,False,3960,Wisconsin
17,School Totals,200,31,53,.585,26,41,.634,5,12,.417,25,30,.833,8,25,33,12,2,2,10,23,92,False,3961,Wisconsin
14,School Totals,200,29,66,.439,23,46,.500,6,20,.300,14,22,.636,14,23,37,14,4,2,6,15,78,False,3962,Wisconsin
10,School Totals,200,20,63,.317,15,44,.341,5,19,.263,16,20,.800,17,19,36,10,5,3,14,21,61,False,3963,Wisconsin
10,School Totals,200,26,49,.531,21,39,.538,5,10,.500,17,24,.708,9,24,33,13,4,7,17,21,74,False,3964,Wisconsin
13,School Totals,200,29,56,.518,23,36,.639,6,20,.300,21,26,.808,9,15,24,17,9,2,12,18,85,False,3965,Wisconsin
9,School Totals,200,16,68,.235,9,35,.257,7,33,.212,9,13,.692,15,24,39,8,2,3,7,17,48,False,3966,Wisconsin
9,School Totals,225,25,60,.417,20,42,.476,5,18,.278,11,12,.917,15,35,50,15,4,7,18,18,66,False,3967,Wisconsin
9,School Totals,200,27,59,.458,21,48,.438,6,11,.545,16,21,.762,9,25,34,13,5,2,6,13,76,False,3968,Wisconsin
8,School Totals,200,20,55,.364,16,45,.356,4,10,.400,23,32,.719,11,30,41,7,2,4,9,21,67,False,3969,Wisconsin
9,School Totals,200,24,66,.364,18,49,.367,6,17,.353,1,4,.250,11,22,33,12,7,4,7,16,55,False,3970,Wisconsin
10,School Totals,200,20,44,.455,14,28,.500,6,16,.375,18,31,.581,15,25,40,12,5,5,14,12,64,False,3971,Wisconsin
10,School Totals,200,27,55,.491,20,39,.513,7,16,.438,23,32,.719,10,31,41,15,9,6,26,16,84,False,3972,Wisconsin
10,School Totals,200,22,57,.386,17,40,.425,5,17,.294,6,8,.750,5,17,22,9,7,5,7,19,55,False,3789,Wisconsin
15,School Totals,200,31,58,.534,23,40,.575,8,18,.444,9,15,.600,6,27,33,14,6,4,9,15,79,False,2368,Wisconsin
10,School Totals,200,19,46,.413,15,30,.500,4,16,.250,16,23,.696,7,13,20,6,9,1,11,16,58,False,216,Wisconsin
10,School Totals,200,24,62,.387,17,41,.415,7,21,.333,5,11,.455,9,21,30,8,8,3,8,15,60,False,609,Wisconsin
9,School Totals,200,24,51,.471,17,30,.567,7,21,.333,10,13,.769,6,15,21,19,8,1,10,21,65,False,3608,Wisconsin
11,School Totals,200,21,47,.447,15,33,.455,6,14,.429,29,36,.806,7,15,22,6,4,1,6,15,77,False,1384,Wisconsin
12,School Totals,200,20,48,.417,16,38,.421,4,10,.400,22,35,.629,10,22,32,9,7,2,10,21,66,False,2042,Wisconsin
11,School Totals,225,25,48,.521,21,36,.583,4,12,.333,28,37,.757,8,18,26,5,9,5,16,17,82,False,221,Wisconsin
10,School Totals,200,22,50,.440,20,36,.556,2,14,.143,17,20,.850,7,27,34,8,6,1,12,16,63,False,2652,Wisconsin
10,School Totals,200,28,57,.491,15,30,.500,13,27,.481,10,17,.588,11,22,33,15,5,1,10,14,79,False,1738,Wisconsin
11,School Totals,200,22,43,.512,11,25,.440,11,18,.611,17,28,.607,4,19,23,13,4,2,11,13,72,False,3412,Wisconsin
10,School Totals,200,23,56,.411,11,30,.367,12,26,.462,12,18,.667,12,25,37,13,5,2,10,18,70,False,619,Wisconsin
12,School Totals,200,20,59,.339,14,39,.359,6,20,.300,11,17,.647,13,17,30,13,4,3,8,10,57,False,1389,Wisconsin
10,School Totals,200,19,44,.432,14,24,.583,5,20,.250,26,33,.788,5,26,31,13,9,2,6,12,69,False,2655,Wisconsin
10,School Totals,200,25,52,.481,15,29,.517,10,23,.435,7,12,.583,7,20,27,17,8,4,10,20,67,False,2924,Wisconsin
15,School Totals,200,24,49,.490,16,28,.571,8,21,.381,12,15,.800,7,24,31,14,6,4,11,12,68,False,1007,Wisconsin
14,School Totals,200,24,52,.462,17,32,.531,7,20,.350,7,14,.500,8,23,31,12,6,6,10,20,62,False,3173,Wisconsin
10,School Totals,200,26,60,.433,13,31,.419,13,29,.448,15,20,.750,8,14,22,12,6,1,6,23,80,False,3790,Wisconsin
10,School Totals,200,16,53,.302,12,33,.364,4,20,.200,22,30,.733,7,21,28,9,7,1,12,18,58,False,3415,Wisconsin
10,School Totals,200,17,53,.321,13,34,.382,4,19,.211,9,15,.600,7,24,31,6,6,2,6,11,47,False,3973,Wisconsin
10,School Totals,200,25,59,.424,17,32,.531,8,27,.296,8,13,.615,7,30,37,12,3,6,12,21,66,False,3974,Wisconsin
10,School Totals,200,23,57,.404,17,37,.459,6,20,.300,4,6,.667,12,23,35,11,8,4,17,15,56,False,3975,Wisconsin
16,School Totals,200,25,53,.472,14,24,.583,11,29,.379,18,23,.783,12,29,41,14,6,6,11,17,79,False,3976,Wisconsin
11,School Totals,200,26,63,.413,15,24,.625,11,39,.282,4,5,.800,12,26,38,15,4,1,16,22,67,False,3977,Wisconsin
16,School Totals,200,26,58,.448,21,39,.538,5,19,.263,12,19,.632,16,27,43,18,5,2,13,12,69,False,3978,Wisconsin
11,School Totals,200,27,48,.563,20,29,.690,7,19,.368,13,19,.684,7,25,32,16,7,5,17,12,74,False,3979,Wisconsin
14,School Totals,200,28,65,.431,23,43,.535,5,22,.227,12,16,.750,18,28,46,12,5,5,13,18,73,False,3980,Wisconsin
16,School Totals,200,21,55,.382,13,33,.394,8,22,.364,6,10,.600,4,21,25,12,8,5,10,12,56,False,3981,Wisconsin
16,School Totals,200,33,59,.559,24,32,.750,9,27,.333,20,27,.741,14,26,40,15,4,4,11,14,95,False,3982,Wisconsin
16,School Totals,200,29,59,.492,18,36,.500,11,23,.478,8,16,.500,13,25,38,21,4,1,12,14,77,False,3983,Wisconsin
11,School Totals,200,33,63,.524,21,36,.583,12,27,.444,12,20,.600,8,20,28,15,5,4,5,14,90,False,3984,Wisconsin
16,School Totals,200,30,58,.517,24,38,.632,6,20,.300,12,22,.545,12,32,44,11,9,4,10,16,78,False,3985,Wisconsin
9,School Totals,200,32,55,.582,24,37,.649,8,18,.444,21,29,.724,6,24,30,20,9,6,9,18,93,False,3986,Wisconsin
13,School Totals,200,27,58,.466,22,43,.512,5,15,.333,14,21,.667,8,24,32,18,13,3,9,15,73,False,3987,Wisconsin
16,School Totals,200,34,65,.523,22,38,.579,12,27,.444,10,11,.909,13,37,50,23,9,1,13,13,90,False,3988,Wisconsin
16,School Totals,200,23,53,.434,18,36,.500,5,17,.294,21,28,.750,11,26,37,10,10,6,13,15,72,False,2392,Wisconsin
10,School Totals,200,28,56,.500,18,36,.500,10,20,.500,9,14,.643,7,16,23,12,9,4,7,15,75,False,250,Wisconsin
12,School Totals,200,23,59,.390,21,45,.467,2,14,.143,7,10,.700,5,14,19,12,9,1,9,17,55,False,3805,Wisconsin
16,School Totals,200,36,73,.493,24,51,.471,12,22,.545,5,15,.333,14,23,37,19,8,2,8,17,89,False,1762,Wisconsin
10,School Totals,200,24,53,.453,18,37,.486,6,16,.375,14,24,.583,8,22,30,11,5,3,8,15,68,False,1030,Wisconsin
11,School Totals,225,31,62,.500,24,48,.500,7,14,.500,9,13,.692,7,27,34,19,5,6,12,13,78,False,3189,Wisconsin
15,School Totals,200,26,55,.473,17,32,.531,9,23,.391,21,29,.724,12,23,35,15,7,1,11,15,82,False,2067,Wisconsin
11,School Totals,225,20,60,.333,17,35,.486,3,25,.120,18,28,.643,12,26,38,10,7,5,14,20,61,False,2396,Wisconsin
11,School Totals,200,24,59,.407,17,36,.472,7,23,.304,2,9,.222,17,25,42,10,7,5,11,12,57,False,2675,Wisconsin
11,School Totals,200,19,48,.396,15,31,.484,4,17,.235,23,31,.742,11,19,30,9,8,5,13,16,65,False,259,Wisconsin
11,School Totals,225,23,63,.365,15,41,.366,8,22,.364,16,24,.667,15,20,35,9,9,3,11,25,70,False,3431,Wisconsin
10,School Totals,200,19,50,.380,12,31,.387,7,19,.368,14,19,.737,8,21,29,10,4,4,12,12,59,False,3624,Wisconsin
10,School Totals,200,23,60,.383,20,44,.455,3,16,.188,9,9,1.000,10,24,34,12,5,5,10,15,58,False,1035,Wisconsin
11,School Totals,200,24,58,.414,22,46,.478,2,12,.167,21,37,.568,18,26,44,9,7,4,7,23,71,False,654,Wisconsin
12,School Totals,200,25,57,.439,12,27,.444,13,30,.433,10,15,.667,6,14,20,11,4,4,7,23,73,False,1769,Wisconsin
11,School Totals,200,28,65,.431,23,47,.489,5,18,.278,13,25,.520,15,23,38,12,8,3,8,22,74,False,1422,Wisconsin
11,School Totals,200,23,54,.426,17,31,.548,6,23,.261,5,14,.357,7,18,25,9,9,1,13,14,57,False,2946,Wisconsin
12,School Totals,200,25,57,.439,15,39,.385,10,18,.556,6,16,.375,10,27,37,14,7,5,10,14,66,False,3191,Wisconsin
11,School Totals,200,27,57,.474,17,35,.486,10,22,.455,6,11,.545,7,23,30,15,6,0,7,11,70,False,268,Wisconsin
14,School Totals,200,27,57,.474,15,28,.536,12,29,.414,10,15,.667,11,23,34,13,7,3,8,11,76,False,3626,Wisconsin
9,School Totals,200,22,56,.393,16,41,.390,6,15,.400,6,8,.750,12,18,30,10,4,3,13,13,56,False,1044,Wisconsin
11,School Totals,200,26,60,.433,13,29,.448,13,31,.419,19,25,.760,14,19,33,19,4,3,8,22,84,False,3989,Wisconsin
11,School Totals,200,26,49,.531,20,31,.645,6,18,.333,7,16,.438,9,19,28,10,4,5,14,19,65,False,3990,Wisconsin
10,School Totals,225,28,55,.509,21,38,.553,7,17,.412,20,30,.667,8,24,32,14,9,2,13,26,83,False,3991,Wisconsin
15,School Totals,200,32,56,.571,22,33,.667,10,23,.435,11,18,.611,8,31,39,18,7,3,13,9,85,False,3992,Wisconsin
14,School Totals,200,31,61,.508,24,39,.615,7,22,.318,20,26,.769,6,27,33,13,9,2,7,19,89,False,3993,Wisconsin
11,School Totals,200,25,61,.410,18,37,.486,7,24,.292,13,21,.619,6,19,25,13,7,2,7,21,70,False,3994,Wisconsin
11,School Totals,200,23,58,.397,16,37,.432,7,21,.333,12,18,.667,10,20,30,13,2,4,8,20,65,False,3995,Wisconsin
11,School Totals,200,25,52,.481,20,30,.667,5,22,.227,15,22,.682,4,19,23,9,7,1,12,18,70,False,3996,Wisconsin
15,School Totals,200,27,54,.500,17,35,.486,10,19,.526,7,10,.700,12,25,37,14,3,2,9,14,71,False,3997,Wisconsin
10,School Totals,200,15,48,.313,12,28,.429,3,20,.150,4,7,.571,8,20,28,6,5,1,14,10,37,False,3998,Wisconsin
13,School Totals,200,19,49,.388,9,22,.409,10,27,.370,10,12,.833,5,12,17,10,5,1,13,18,58,False,1780,Wisconsin
9,School Totals,200,23,52,.442,18,41,.439,5,11,.455,13,19,.684,8,25,33,13,8,4,9,23,64,False,2085,Wisconsin
10,School Totals,200,23,56,.411,18,36,.500,5,20,.250,4,6,.667,8,22,30,14,4,2,10,14,55,False,3999,Wisconsin
10,School Totals,200,23,54,.426,19,42,.452,4,12,.333,13,20,.650,8,18,26,11,4,5,11,10,63,False,4000,Wisconsin
11,School Totals,200,28,51,.549,16,31,.516,12,20,.600,13,23,.565,7,15,22,17,5,7,15,14,81,False,4001,Wisconsin
14,School Totals,200,30,56,.536,25,37,.676,5,19,.263,16,20,.800,10,27,37,13,5,6,14,13,81,False,4002,Wisconsin
11,School Totals,200,26,51,.510,19,31,.613,7,20,.350,23,32,.719,7,22,29,14,5,6,8,16,82,False,4003,Wisconsin
13,School Totals,200,32,57,.561,24,42,.571,8,15,.533,10,14,.714,12,22,34,17,5,1,10,13,82,False,4004,Wisconsin
10,School Totals,200,23,47,.489,16,32,.500,7,15,.467,18,24,.750,12,17,29,12,6,4,14,13,71,False,284,Wisconsin
11,School Totals,200,23,47,.489,21,34,.618,2,13,.154,12,15,.800,6,24,30,13,4,3,14,18,60,False,2418,Wisconsin
11,School Totals,200,25,59,.424,20,40,.500,5,19,.263,4,10,.400,8,23,31,11,5,4,7,21,59,False,3447,Wisconsin
12,School Totals,200,17,48,.354,11,29,.379,6,19,.316,10,12,.833,8,22,30,10,5,2,20,16,50,False,3822,Wisconsin
13,School Totals,200,26,49,.531,19,30,.633,7,19,.368,16,21,.762,9,16,25,15,8,10,11,12,75,False,2701,Wisconsin
11,School Totals,200,26,65,.400,22,47,.468,4,18,.222,11,14,.786,9,21,30,15,7,1,10,20,67,False,2963,Wisconsin
13,School Totals,200,21,58,.362,16,34,.471,5,24,.208,14,16,.875,7,16,23,10,7,3,9,19,61,False,1446,Wisconsin
10,School Totals,200,20,47,.426,13,27,.481,7,20,.350,16,31,.516,5,26,31,12,1,4,13,24,63,False,3448,Wisconsin
10,School Totals,200,19,58,.328,12,32,.375,7,26,.269,7,10,.700,11,16,27,11,7,3,10,13,52,False,3643,Wisconsin
11,School Totals,200,24,57,.421,17,36,.472,7,21,.333,8,11,.727,11,15,26,12,3,3,8,18,63,False,684,Wisconsin
11,School Totals,200,25,47,.532,17,32,.531,8,15,.533,20,27,.741,7,23,30,20,6,6,10,22,78,False,2702,Wisconsin
12,School Totals,200,27,55,.491,20,38,.526,7,17,.412,11,14,.786,4,15,19,10,2,4,8,20,72,False,1072,Wisconsin
10,School Totals,200,20,51,.392,16,30,.533,4,21,.190,13,20,.650,6,29,35,10,6,4,9,20,57,False,3823,Wisconsin
10,School Totals,225,25,55,.455,13,26,.500,12,29,.414,11,18,.611,6,21,27,15,8,5,11,12,73,False,3211,Wisconsin
11,School Totals,200,24,45,.533,15,25,.600,9,20,.450,13,18,.722,7,13,20,16,9,5,9,16,70,False,3644,Wisconsin
11,School Totals,200,22,59,.373,17,41,.415,5,18,.278,14,19,.737,10,15,25,7,4,1,4,16,63,False,1453,Wisconsin
10,School Totals,200,18,50,.360,15,32,.469,3,18,.167,20,24,.833,10,17,27,5,9,5,6,14,59,False,691,Wisconsin
10,School Totals,200,26,57,.456,20,40,.500,6,17,.353,2,6,.333,8,16,24,12,2,3,6,17,60,False,1454,Wisconsin
13,School Totals,196,25,61,.410,13,29,.448,12,32,.375,23,26,.885,11,25,36,17,4,8,5,15,85,False,4005,Wisconsin
10,School Totals,200,31,62,.500,22,46,.478,9,16,.563,6,13,.462,12,27,39,14,4,4,7,15,77,False,4006,Wisconsin
13,School Totals,200,35,58,.603,28,40,.700,7,18,.389,19,25,.760,6,27,33,18,6,4,10,14,96,False,4007,Wisconsin
14,School Totals,200,23,54,.426,22,46,.478,1,8,.125,15,19,.789,6,35,41,2,5,11,11,16,62,False,4008,Wisconsin
11,School Totals,200,28,59,.475,14,37,.378,14,22,.636,8,11,.727,7,21,28,16,8,3,7,12,78,False,4009,Wisconsin
11,School Totals,200,21,48,.438,19,37,.514,2,11,.182,2,3,.667,4,27,31,13,4,5,11,11,46,False,4010,Wisconsin
11,School Totals,200,28,57,.491,17,36,.472,11,21,.524,12,20,.600,7,22,29,16,3,4,10,12,79,False,4011,Wisconsin
12,School Totals,200,27,56,.482,19,32,.594,8,24,.333,10,14,.714,4,27,31,13,5,1,9,24,72,False,2974,Wisconsin
10,School Totals,200,29,54,.537,24,40,.600,5,14,.357,6,13,.462,4,21,25,7,4,1,5,11,69,False,2434,Wisconsin
11,School Totals,225,27,54,.500,22,30,.733,5,24,.208,10,21,.476,2,32,34,15,4,2,12,21,69,False,4012,Wisconsin
12,School Totals,200,37,66,.561,21,32,.656,16,34,.471,11,14,.786,13,30,43,28,10,2,10,5,101,False,4013,Wisconsin
13,School Totals,200,28,57,.491,20,36,.556,8,21,.381,20,26,.769,8,27,35,17,8,4,10,16,84,False,4014,Wisconsin
10,School Totals,200,31,68,.456,25,47,.532,6,21,.286,8,11,.727,7,22,29,9,5,1,7,17,76,False,4015,Wisconsin
10,School Totals,200,20,48,.417,15,26,.577,5,22,.227,7,17,.412,2,22,24,5,8,5,10,17,52,False,3225,Wisconsin
13,School Totals,200,30,61,.492,22,45,.489,8,16,.500,3,5,.600,7,21,28,17,9,6,6,14,71,False,2118,Wisconsin
9,School Totals,225,30,56,.536,21,40,.525,9,16,.563,11,19,.579,8,20,28,13,2,3,17,22,80,False,3838,Wisconsin
10,School Totals,200,23,60,.383,12,30,.400,11,30,.367,3,6,.500,8,21,29,13,5,3,7,23,60,False,708,Wisconsin
10,School Totals,200,26,58,.448,21,45,.467,5,13,.385,7,9,.778,6,23,29,17,7,3,11,11,64,False,1102,Wisconsin
10,School Totals,200,24,47,.511,17,33,.515,7,14,.500,17,21,.810,8,26,34,12,5,4,17,22,72,False,2721,Wisconsin
12,School Totals,200,24,56,.429,15,37,.405,9,19,.474,5,9,.556,2,30,32,15,5,6,7,13,62,False,3656,Wisconsin
12,School Totals,200,24,55,.436,15,32,.469,9,23,.391,5,11,.455,7,26,33,12,4,2,7,19,62,False,3461,Wisconsin
12,School Totals,200,23,49,.469,14,31,.452,9,18,.500,14,23,.609,4,20,24,13,7,4,4,14,69,False,713,Wisconsin
10,School Totals,200,19,55,.345,13,33,.394,6,22,.273,12,18,.667,8,20,28,10,5,8,5,13,56,False,3227,Wisconsin
10,School Totals,200,24,59,.407,20,47,.426,4,12,.333,0,2,.000,7,25,32,5,2,5,7,13,52,False,1107,Wisconsin
10,School Totals,200,24,56,.429,18,36,.500,6,20,.300,5,12,.417,5,22,27,10,7,5,10,12,59,False,1479,Wisconsin
10,School Totals,200,22,55,.400,17,37,.459,5,18,.278,15,23,.652,12,26,38,9,6,5,10,14,64,False,2724,Wisconsin
11,School Totals,200,25,55,.455,18,36,.500,7,19,.368,12,16,.750,6,28,34,12,1,4,10,15,69,False,3657,Wisconsin
10,School Totals,250,27,69,.391,21,47,.447,6,22,.273,13,25,.520,10,26,36,12,2,4,8,17,73,False,328,Wisconsin
10,School Totals,200,22,55,.400,17,42,.405,5,13,.385,12,18,.667,5,25,30,12,6,4,5,16,61,False,2128,Wisconsin
13,School Totals,200,22,54,.407,18,34,.529,4,20,.200,17,27,.630,15,31,46,10,7,5,15,13,65,False,2985,Wisconsin
10,School Totals,225,27,65,.415,20,44,.455,7,21,.333,12,20,.600,10,33,43,13,1,3,8,12,73,False,1824,Wisconsin
9,School Totals,200,24,50,.480,17,31,.548,7,19,.368,11,12,.917,7,24,31,17,3,5,15,12,66,False,3465,Wisconsin
13,School Totals,200,24,68,.353,22,49,.449,2,19,.105,5,9,.556,9,19,28,9,7,5,5,15,55,False,1484,Wisconsin
11,School Totals,200,20,60,.333,14,30,.467,6,30,.200,8,13,.615,14,18,32,9,8,1,13,15,54,False,4016,Wisconsin
10,School Totals,225,22,52,.423,17,33,.515,5,19,.263,14,20,.700,6,20,26,8,1,4,14,14,63,False,4017,Wisconsin
13,School Totals,200,21,55,.382,18,37,.486,3,18,.167,20,24,.833,12,29,41,7,6,12,11,13,65,False,4018,Wisconsin
14,School Totals,200,29,55,.527,19,27,.704,10,28,.357,15,18,.833,6,18,24,19,10,3,9,15,83,False,4019,Wisconsin
14,School Totals,200,24,56,.429,13,33,.394,11,23,.478,18,20,.900,9,24,33,11,6,3,12,19,77,False,4020,Wisconsin
11,School Totals,200,32,62,.516,17,31,.548,15,31,.484,9,10,.900,8,30,38,24,3,1,13,15,88,False,4021,Wisconsin
9,School Totals,200,17,50,.340,10,23,.435,7,27,.259,11,14,.786,6,28,34,7,6,2,13,14,52,False,4022,Wisconsin
9,School Totals,200,18,53,.340,16,27,.593,2,26,.077,12,16,.750,11,22,33,6,5,1,12,16,50,False,4023,Wisconsin
9,School Totals,200,21,56,.375,16,33,.485,5,23,.217,7,15,.467,13,21,34,7,3,4,9,11,54,False,4024,Wisconsin
13,School Totals,200,30,56,.536,22,36,.611,8,20,.400,16,18,.889,6,20,26,13,5,6,4,18,84,False,344,Wisconsin
9,School Totals,200,23,48,.479,15,25,.600,8,23,.348,11,16,.688,3,19,22,9,5,4,14,17,65,False,2457,Wisconsin
14,School Totals,200,26,52,.500,16,30,.533,10,22,.455,21,26,.808,7,27,34,17,6,4,9,19,83,False,4025,Wisconsin
13,School Totals,200,25,57,.439,14,31,.452,11,26,.423,7,9,.778,4,22,26,13,7,2,9,20,68,False,4026,Wisconsin
15,School Totals,200,24,55,.436,11,24,.458,13,31,.419,4,7,.571,5,34,39,18,6,7,14,14,65,False,4027,Wisconsin
10,School Totals,200,21,56,.375,15,33,.455,6,23,.261,13,16,.813,10,22,32,8,5,0,8,16,61,False,1840,Wisconsin
10,School Totals,200,23,53,.434,19,38,.500,4,15,.267,20,23,.870,9,22,31,5,3,6,7,16,70,False,2741,Wisconsin
10,School Totals,200,22,55,.400,16,34,.471,6,21,.286,8,14,.571,9,26,35,10,3,2,9,17,58,False,2145,Wisconsin
10,School Totals,200,22,49,.449,15,28,.536,7,21,.333,5,8,.625,4,19,23,11,5,2,6,13,56,False,740,Wisconsin
10,School Totals,200,21,59,.356,17,40,.425,4,19,.211,9,11,.818,6,23,29,11,5,3,9,12,55,False,1506,Wisconsin
15,School Totals,200,29,63,.460,11,29,.379,18,34,.529,6,8,.750,9,29,38,23,5,4,10,16,82,False,3481,Wisconsin
11,School Totals,200,20,46,.435,13,24,.542,7,22,.318,4,8,.500,2,13,15,12,3,5,11,9,51,False,3854,Wisconsin
9,School Totals,200,24,64,.375,16,36,.444,8,28,.286,6,11,.545,9,29,38,12,2,4,9,28,62,False,3003,Wisconsin
9,School Totals,200,22,54,.407,14,29,.483,8,25,.320,12,15,.800,3,26,29,10,8,4,10,9,64,False,1509,Wisconsin
10,School Totals,200,19,67,.284,12,38,.316,7,29,.241,7,11,.636,13,27,40,9,1,3,6,15,52,False,3245,Wisconsin
14,School Totals,200,24,58,.414,12,26,.462,12,32,.375,10,12,.833,10,18,28,17,7,5,8,16,70,False,1845,Wisconsin
12,School Totals,200,31,63,.492,16,32,.500,15,31,.484,4,5,.800,6,32,38,19,3,4,11,14,81,False,3482,Wisconsin
9,School Totals,200,19,50,.380,7,19,.368,12,31,.387,19,20,.950,9,18,27,13,3,3,8,14,69,False,3855,Wisconsin
9,School Totals,200,24,50,.480,13,28,.464,11,22,.500,20,26,.769,4,24,28,13,2,2,11,12,79,False,2469,Wisconsin
9,School Totals,200,29,54,.537,18,31,.581,11,23,.478,12,15,.800,3,25,28,10,1,2,8,15,81,False,1145,Wisconsin
9,School Totals,200,23,58,.397,15,34,.441,8,24,.333,17,24,.708,7,23,30,11,5,6,4,19,71,False,3247,Wisconsin
11,School Totals,200,23,59,.390,15,34,.441,8,25,.320,9,12,.750,6,32,38,8,2,3,8,15,63,False,3671,Wisconsin
9,School Totals,200,22,53,.415,13,31,.419,9,22,.409,7,10,.700,5,27,32,12,6,3,9,15,60,False,366,Wisconsin
13,School Totals,200,24,57,.421,17,34,.500,7,23,.304,22,29,.759,7,28,35,16,6,10,7,15,77,False,4028,Wisconsin
15,School Totals,200,31,59,.525,21,40,.525,10,19,.526,20,27,.741,6,29,35,17,9,7,7,19,92,False,4029,Wisconsin
16,School Totals,200,34,61,.557,25,41,.610,9,20,.450,5,6,.833,9,36,45,18,4,7,10,15,82,False,4030,Wisconsin
10,School Totals,200,21,56,.375,14,32,.438,7,24,.292,16,19,.842,10,21,31,11,5,4,10,22,65,False,4031,Wisconsin
10,School Totals,200,20,52,.385,13,30,.433,7,22,.318,26,36,.722,7,23,30,9,5,5,9,22,73,False,4032,Wisconsin
10,School Totals,200,25,57,.439,15,39,.385,10,18,.556,17,23,.739,5,26,31,11,4,3,4,16,77,False,4033,Wisconsin
14,School Totals,200,31,57,.544,15,32,.469,16,25,.640,7,11,.636,6,22,28,22,9,3,9,15,85,False,4034,Wisconsin
12,School Totals,200,22,55,.400,14,29,.483,8,26,.308,15,15,1.000,5,34,39,14,0,1,11,12,67,False,3491,Wisconsin
9,School Totals,200,27,51,.529,19,32,.594,8,19,.421,23,30,.767,3,23,26,18,7,4,6,16,85,False,1523,Wisconsin
9,School Totals,200,24,55,.436,16,34,.471,8,21,.381,8,15,.533,7,21,28,12,3,1,6,15,64,False,762,Wisconsin
12,School Totals,200,30,59,.508,24,44,.545,6,15,.400,5,8,.625,8,27,35,12,3,3,9,15,71,False,3257,Wisconsin
9,School Totals,250,28,66,.424,20,47,.426,8,19,.421,16,20,.800,5,28,33,14,10,0,7,14,80,False,379,Wisconsin
11,School Totals,200,20,65,.308,11,37,.297,9,28,.321,5,6,.833,7,21,28,8,4,2,10,6,54,False,1157,Wisconsin
9,School Totals,200,19,54,.352,13,29,.448,6,25,.240,16,21,.762,7,26,33,10,10,9,9,17,60,False,2478,Wisconsin
14,School Totals,200,24,55,.436,14,28,.500,10,27,.370,10,11,.909,4,25,29,14,5,2,8,13,68,False,3676,Wisconsin
9,School Totals,200,23,57,.404,16,29,.552,7,28,.250,9,15,.600,5,22,27,14,7,4,9,19,62,False,1866,Wisconsin
9,School Totals,200,22,56,.393,12,30,.400,10,26,.385,7,7,1.000,7,29,36,11,4,2,12,15,61,False,769,Wisconsin
9,School Totals,200,29,66,.439,22,38,.579,7,28,.250,6,8,.750,10,28,38,14,2,5,12,21,71,False,2164,Wisconsin
14,School Totals,200,25,52,.481,16,34,.471,9,18,.500,13,16,.813,8,23,31,16,8,1,15,13,72,False,2165,Wisconsin
9,School Totals,200,25,60,.417,21,36,.583,4,24,.167,6,11,.545,2,17,19,6,10,4,11,16,60,False,2759,Wisconsin
14,School Totals,200,20,62,.323,11,30,.367,9,32,.281,12,17,.706,7,25,32,12,9,3,7,16,61,False,3492,Wisconsin
9,School Totals,200,21,54,.389,15,35,.429,6,19,.316,11,12,.917,3,22,25,11,5,5,9,18,59,False,1160,Wisconsin
9,School Totals,200,21,70,.300,8,36,.222,13,34,.382,7,12,.583,15,19,34,13,3,4,5,19,62,False,3020,Wisconsin
14,School Totals,200,23,57,.404,14,31,.452,9,26,.346,13,15,.867,6,26,32,17,10,3,8,10,68,False,3678,Wisconsin
9,School Totals,200,24,69,.348,14,38,.368,10,31,.323,11,15,.733,11,16,27,10,13,3,7,19,69,False,2764,Wisconsin
9,School Totals,200,23,57,.404,16,28,.571,7,29,.241,16,21,.762,9,16,25,11,1,5,6,21,69,False,3863,Wisconsin
9,School Totals,200,28,60,.467,19,36,.528,9,24,.375,8,8,1.000,2,21,23,16,7,2,6,21,73,False,3022,Wisconsin
9,School Totals,200,25,54,.463,13,31,.419,12,23,.522,13,15,.867,4,19,23,18,4,4,8,16,75,False,2172,Wisconsin
9,School Totals,200,22,57,.386,15,40,.375,7,17,.412,6,6,1.000,8,25,33,11,3,4,12,15,57,False,3023,Wisconsin
16,School Totals,200,31,61,.508,18,34,.529,13,27,.481,10,12,.833,7,27,34,15,5,8,6,11,85,False,4035,Wisconsin
13,School Totals,200,25,55,.455,17,34,.500,8,21,.381,5,7,.714,7,22,29,13,0,5,13,18,63,False,4036,Wisconsin
